Slav	スラブ人;《the Slavs》スラブ民族(ロシア人・ポーランド人・チェコ人・ブルガリア人・スロバキア人など) / スラブ人の,スラブ民族の;スラブ語の
Slavic	スラブ民族の,スラブ語族の / スラブ語族
Slavonic	=Slavic
Slovak	〈C〉スロバキア人 / 〈U〉スロバキア語 / スロバキア人の / スロバキア語の
Sm	samariumの化学記号
Smokey	森林火災防止マーク 《森林消防団員の服を着た熊の漫画》[しばしば s-] / 《俗》 ハイウェーパトロール警官 《その制帽が森林消防団マスコットの熊のかぶる帽子に似ているところから》
Sn	tin の化学記号
Snow Belt	降雪地帯(米国の北東地方をいう) 大西洋からロッキー山脈北部に至る北部地帯
Snr.	Senior
So.	south
SoHo	ソーホー(ニューヨークのマンハッタンの一地域;美術館やスタジオ街で有名) South of Houston Streetの略
Socialist Party	社会党
Society of Friends	キリスト友会(ゆうかい)(この会員が通例Quakersと呼ばれるキリスト教の一派)
Socrates	ソクラテス(ギリシアの哲学者;469?‐399B.C.)
Socratic method	ソクラテス式問答法
Sodom	ソドム(旧約聖書で死海南岸にあったとされる古代都市;罪悪のため神に滅ぼされた)
Sofia	ソフィア(ブルガリアの首都)
Soho	ソーホー(ロンドン市内の歓楽街で外国人経営のレストランが多い)
Sol	(ローマ神話の)太陽の神 / 《文》太陽
Sol.	Solicitor / Solomon
Solomon	ソロモン大王(紀元前10世紀ごろの賢明なイスラエルの大王) / 〈C〉(ソロモンのような)賢い人
Solon	ソロン(638?‐559?B.C.;古代アテネの立法家) / 〈C〉《米》立法府の議員
Somalia	ソマリア(アフリカ東岸の共和国)
Sophocles	ソフォクレス(古代ギリシアの悲劇詩人;紀元前496?‐406?)
South Africa	南アフリカ(アフリカ南部の共和国で,公式名は the Republic of South Africa;首都は,行政府 Pretoria,立法府 Cape Town,司法府 Bloemfontein)
South African	南アフリカの / 南アフリカ共和国の / 南アフリカ人
South America	南アメリカ,南米(西半球の南部では第4の広さの大陸)
South American	南米の,南米人の / 南米人
South Carolina	サウスカロライナ州(大西洋に面する米国南東部の州;州都はColumbia;《略》『S.C.,SC』)
South China Sea	南シナ海(中国の南東に広がる海域)
South Dakota	サウスダコタ州(米国中北部の州;州都はPierre;《略》『S.Dak.,S.D.,SD』)
South Island	南島(ニュージーランド最大の島)
South Korea	韓国(朝鮮半島の北緯38゜以南の共和国;公式名はthe Republic of Korea(大韓民国);首都Seoul)
South Pole	南極
South Sea Islands	南太平洋諸島
South Seas	赤道以南の海;南太平洋
South-West Africa	南西アフリカ(南アフリカ共和国の委任統治領だった) 現在は Namibia
Southeast Asia	東南アジア
Southern Hemisphere	南半球
Southern Yemen	南イエメン(アジア南西部の共和国;公式名People's Democratic Republic of Yemen(イエメン民主人民共和国);首都Aden)
Soviet Russia	旧ソ連(the Soviet Union)の通称
Soviet Union	《the~》『ソビエト連邦』(15の共和国より成る世界最大の国で公式名はthe Union of Soviet Socialist Republics(ソビエト社会主義共和国連邦);首都はMoscow) 1991年に崩壊 略は USSR
Sp.	Spain / Spaniard / Spanish
Spain	『スペイン』(ヨーロッパ南西部の王国;首都はMadrid)
Spaniard	スペイン人
Spanish	《the ~》《集合的に》『スペイン人』 / 『スペイン語』 / 『スペイン』[人]『の』;スペイン語の
Spanish America	スペイン語圏中南米諸国
Spanish American	スペイン語圏中南米人 / スペイン系アメリカ人 / スペインのアメリカの,スペインとアメリカ合衆国の / スペイン語圏中南米の
Spanish American War	米西戦争(1898年)
Spanish Armada	スペインの無敵艦隊(1588年英国を攻撃したが敗北し,その後暴風雨のために全滅した)
Spanish Main	南米北部カリブ海沿岸 / カリブ海(Caribbean Sea)(植民地時代のスペイン商船の航路で海賊が出没した)
Spanish fly	(またcantharis)〈C〉ハンミョウ[類のこん虫] / (またcantharides)〈U〉カンタリデス(ハンミョウを粉末にした薬)
Spanish moss	サルオガセモドキ(米国南部の樹木に寄生する灰色がかった緑のこけ)
Sparta	スパルタ(古代ギリシアの都市国家;兵士の厳格な訓練で有名)
Spartan	スパルタ[人,文化]の / スパルタ式の,質実剛健な,鍛練の厳しい / スパルタ人 / 質実剛健な人
Springer spaniel	スパニエル犬([狩]猟用の犬)
Springfield	スプリングフィールド(米国Illinois州の州都)
Sq.	square{名}2
Sr	strontiumの化学記号
Sr.	Senior / Sir / Sister
Sri	…様,…先生(英語の『Mr.』に相当する)
Sri Lanka	スリランカ(インド洋にある島国の共和国;Ceylonの正式国名;首都Colombo)
Ssh	=sh
St.	Street / Strait / Saint(複SS.,Sts.)聖…,セント…
St. Bernard	=Saint Bernard,St.Bernard
St. Louis	セントルイス(米国Missouri州東部ミシシッピー河畔の港市)
St. Paul	セントポール(ミシシッピー河畔にあるMinnesota州の首都)
St. Paul's	セントポール大聖堂(ロンドンにある大教会堂)
St. Peter's	サンピエトロ大聖堂(イタリアのバチカンにある)
St. Petersburg	ペテルスブルグ(レニングラードの旧称;1703‐1914) / セントピーターズバーグ(米国Florida州の避寒地・引退した人達が温暖な気候を求めて移り住むので年寄りの多い町です)
St. Valentine's Day	=Valentine's Day
St. Vitus's dance	=St. Vitus' dance =Sydenham's disease シデナム病
Stalin	スターリン(『Joseph~』;1879‐1953;ソ連の政治家;首相1941‐53)
Stamp Act	印紙条例(1765年英国が米植民地に課す)
Star Chamber	《the 『S-』『C-』》星法院(陪審を用いず専断と不公平、厳罰で知られた英国の高等法院(1487‐1641)) / 〈C〉(一般に)専断不公正な裁判所(委員会)
Star-Spangled Banner	星条旗(正式の名称;the Stars and Stripesは俗称) / 米国国歌
Stars and Stripes	星条旗
State Enrolled Nurse	准看護婦(《略》『SEN』)
State Registered Nurse	正看護婦(《略》『SRN』)
Staten Island	ステタン島(米国New York湾内の島)
Statue of Liberty	自由の女神(ニューヨーク湾のLiberty Islandにある像)
Ste.	Sainte《女性に用いて》聖…
Sten gun	ステン銃(英国の軽機関銃)
Stetson	ステットソン帽(つば広で山高のフェルト製の帽子,特にカウボーイがかぶる;もと商標名)
Stevenson	スティーブンスン(『Robert Louis』 ~;1850‐94;スコットランド生れの小説家・詩人)
Stewart	=Stuart
Stilton	スチルトンチーズ(英国産の濃厚な白色チーズ)
Stockholm	ストックホルム(スウェーデンの首都)
Stone Age	石器時代(道具や武器に石を使った時代;鉄器時代(Iron Age),青銅器時代(Bronze Age)に先行する)
Stradivarius	ストラディバリウス(イタリアのStradivari(1644‐1737)およびその一族の製作したバイオリンその他の弦楽器;名器として有名)
Stratford on Avon	ストラトフォードオンエイボン(英国中部の都市で,Shakespeareの出生地及び埋葬地)
Strauss	シュトラウス / 『Johann Strauss』(1804-1849;オーストリアの作曲家;「ワルツの父」と呼ばれる) / 『Johann Strauss Jr.』(1825-1899;1の息子で作曲家;「ワルツの王」と呼ばれる) / 『Richard Strauss』(1864-1949;ドイツの作曲家)
Stuart	(また Stewart)英国の王室の名
Stygian	(ギリシア神話で)三途(さんず)の川(Styx)の,地獄の;地獄のような / 《文》暗い,陰うつな
Styrofoam	発泡スチロール(合成樹脂の一種;商標名)
Styx	(ギリシア神話で)三途(さんず)の川
Succoth, Sukkoth	仮庵の祭(秋に収穫を祝うユダヤ教の祭)
Sudan	アフリカ北東部の共和国;首都Khartoum / アフリカのサハラ砂ばくの南部地方名
Suez Canal	スエズ運河(エジプト北東部にあって地中海と紅海とを結ぶ運河)
Sukkoth	=Succoth, Sukkoth
