Augustan	{形}(ローマの)アウグストゥス帝時代の,オーガスタン時代の / 文芸全盛期の,古典主義の
Augustine	聖オーガスチン(アウグスティヌス) / 初期キリスト教会の指導者・哲学者(354‐430) / 英国に布教したローマの宣教師,最初のカンタベリー大主教(?‐604)
Augustinian	聖アウグスティヌス(オーガスチン)の;アウグスティヌス主義の / (ローマカトリック教会で) / アウグスティヌス修道会の修道士 / アウグスティヌスの教義信奉者
Augustus	オーガスタス(ローマ帝国初代皇帝;Julius Caesarの後継者;63B.C.‐A.D.14)
Aunt Sally	パイプ落とし(サリーおばさんと呼ばれる木像の口にくわえさせたパイプを木片などを投げて落とす遊び) / 攻撃の的となる人(物)
Aureomycin	オーレオマイシン(抗生物質の商品名)
Aurora	オーロラ(極地方の夜空に見られる光の現象) / ローマ神話の曙の女神
Aussie	《俗》=Australian
Australasia	オーストラレーシア州(Australia, New Zealandおよび付近の諸島の総称)
Australasian	オーストラレーシア州の / オーストラレーシア人
Australia	『オーストラリア』,豪州(首都はCanberra)
Australian	オーストラリアの,豪州の / オーストラリア人
Australian ballot	オーストラリア式投票(全候補者が記された投票用紙に印をつける)
Australian rules football	オーストラリア式フットボール(2チーム18名で行うラグビーに似た球技)
Austria	『オーストリア』(ヨーロッパ中部の共和国;首都はVienna)
Austrian	オーストリアの / オーストリア人
Austronesia	オーストロネシア(太平洋中南部諸島の総称)
Austronesian	オーストロネシア[語族]の / オーストロネシア語族
Authorized Version	欽定(きんてい)訳聖書(英国王James一世の命によって編集され,1611年に発行された英訳聖書;《略》『A.V.』)
Ave Maria	アベマリア(聖母マリアにささげる祈りの言葉)
Ave.,ave.	Avenue(通り)
Avon	エイボン川(イングランドの中部を流れる川) / エイボン(イングランド中部の州)
Ayrshire	エアシャー州(スコットランド南西部の州で乳牛で有名) / 〈U〉〈C〉エアシャー州産の乳牛
Azores	アゾーレス諸島(北大西洋にあるポルトガル領の諸島)
Azov	アゾフ海(『the Sea of~』;黒海の北東に連なる内海)
Aztec	〈C〉アステカ人(16世紀にスペイン人に征服されたメキシコ中部にいた種族) / 〈U〉アステカ語
a cappella	楽器の伴奏なしで
a fortiori	いっそう有力な理由で;なおさら
a posteriori	(推論が)帰納的に(な);経験的に(な);後天的に(な)
a priori	(推論が)原因より結果を導いて(導いた);演繹(えんえき)的に(な);先験的に(な);先天的に(な)
a,an	不定冠詞。ある(程度)の、一つの、～というもの、～につき、同じ、～のような人、～という名の人、～家の人、～の作品、～のような人、～つきの、一組の…と…、一種の、抽象名詞の具体例・種類・行為など、動詞と同形の名詞に続く名詞、1回の
a.	about / acre[s] / adjective
a.c.	ante cibum 食前服用(before meals)
a.m.,A.M.	《時間を表す数字の後につける》『午前』(ラテン語ante meridiemの略)
a.p.	additional premium 割増保険料 / access point アクセスポイント
aardvark	ツチブタ(シロアリを主食とするアフリカ産の哺乳動物)
ab.	Abbreviation 略語 / Antibody 抗体 / Abdomen 腹部
abaci	abacus(そろばん)の複数形
aback	後へ,後ろに
abacus	そろばん
abaft	船尾に(へ) / …より船尾に
abalone	〈C〉アワビ;〈U〉アワビの身
abandon	…を捨てる,断念する / (詩的・文学的)奔放さ,自由奔放
abandoned	見捨てられた(deserted) / 身を持ちくずした,捨てばちの
abandonment	見捨てること,遺棄 / 自暴自棄
abase	〈品位・地位など〉を落とす,下げる;〈自分〉を卑しめる
abasement	(品位・地位などの)低下,失墜;屈辱
abash	《通例受動態で用いて》…を恥じ入らせる;…をまごつかせる,面くらわせる
abate	…の勢いを減らす,軽減する / (法律で)〈妨害など〉を排除する;〈効力など〉を停止する / 減る,やわらぐ,弱まる
abatement	軽減;緩和;〈C〉減価,減額
abatis	さかもぎ(敵の侵入を防ぐためのとがった柵)
abattoir	畜殺場
abbacy	大修道院長の職(任期)
abbe	〈C〉聖職者(カトリックの), 司祭, 修道士
abbess	女子修道院長
abbey	〈C〉大修道院 / 《集合的に》(一院全体の)僧,尼僧 / 〈C〉(大修道院の一部であった)大寺院;《the A-》ウエストミンスター寺院(Westminster Abbey)
abbot	大修道院長
abbr.	abbreviated / abbreviation
abbreviate	…を短縮する、短くする、簡潔にする
abbreviation	省略;〈C〉省略された語,略語,略字
abdicate	〈地位・権利など〉を捨てる,から退く / 〈王が〉(…から)退位する《+『from』+『名』》
abdication	退位,辞職
abdomen	腹部,腹;(昆虫の)腹部
abdominal	(比較変化なし)腹の,腹部の
abduct	…を誘かいする
abduction	誘拐
abductor	誘拐犯 / (解剖学で)外転筋
abeam	(海事用語で)(…の)真横に《+『of』+『名』》
abecedarian	初心者,初学者
abed	寝床に(in bed)
aberrant	正道からはずれた,常軌を逸した;異常な
aberration	正道からはずれること,非行,異常 / (軽い)精神異常
abet	(特に悪い事に)…を扇動する,そそのかす《+『名』+『in』+『名』(do『ing』)》
abettor, abetter	犯罪や悪事を助けたり、けしかけたりする人
abeyance	一時的な中止(停止)
abhor	…をひどくきらう,嫌悪する
abhorrence	大きらいなもの;〈U〉(…を)大きらいなこと《+『of』+『名』(doing)》
abhorrent	嫌悪(けんお)すべき,憎むべき;(…にとって)嫌悪すべき《+『to』+『名』》
abide	(ある状態に)とどまる;残る / 住む / 《まれ》…をじっと待つ / 《否定文・疑問文で》…をがまんする,に耐える
abiding	永続的な,不変の
ability	〈U〉『能力』,力量 / 《複数形で》特殊な才能,優れた手腕
abject	(人・行為が)下劣な,あさましい / みじめな
abjection	卑しさ,卑劣,下劣
abjuration	宣誓して放棄すること
abjure	〈国籍・信仰・権利など〉を宣誓して捨てる
abl.	ablative
ablate	(手術・溶解・腐食などで)…を除去する / 除去される
ablation	切除,除去;融除 / 溶発(ロケットの先端が大気圏突入で溶解すること)
ablative	奪格の(ラテン語の格変化の一つ) / 奪格
ablaut	母音交替(sit,sat,seatのように語幹母音が変化すること)
ablaze	燃えたって / (…で)明るく輝いて《+『with』+『名』》
able	《補語にのみ用いて》《『be able to』 do》(…することが)『できる』 / 『有能な』,腕ききの,並々ならない
able [bodied] seaman	(英海軍の)上等水兵 / 熟練船員
able-bodied	体のじょうぶな,強壮な
abloom	開花して(した)({形}は補語にのみ用いる)
ablution	《複数形で》(宗教上の儀式としての)沐浴(もくよく)
ably	りっぱに,うまく
abnegate	〈権利など〉を放棄する
abnegation	権利(欲望など)の放棄;禁欲
abnormal	『異常な』,普通でない,規準をはずれた
