appreciate	〈よさ・価値など〉を『認める』,認識する,…のよさを認める / 〈作品など〉を『味わう』,鑑賞する / 〈好意など〉を感謝する,ありがたく思う / 〈相場・価格〉を上げる;…の価格(相場)を上げる / 相場(価格,評価)が上がる
appreciation	〈U〉(…を)『正しく認識すること』,(…の)識別,評価《+『of』+『名』》 / 〈U〉《時にan~》(文学・芸術などの)理解,鑑賞;批評,論評《+『of』+『名』》 / 〈U〉(…に対する)感謝《+『for』+『名』》 / 〈U〉《時にa~》(価格の)騰貴
appreciative	鑑賞眼のある,評価する力のある
apprehend	《文》…を逮捕する,捕える(arrest) / 《古》〈意味〉を理解する / 《まれ》…を気づかう,案じる
apprehension	《しばしば複数形で》《単数扱い》『気づかい』,不安 / 《文》理解[力](understanding) / 逮捕,拘引(arrest)
apprehensive	『心配した』,気づかった
apprentice	(…の職業見習いの)徒弟,(昔の)年季奉公人《+『to』+『名』》 / (…に)〈人〉を徒弟に出す,見習い奉公に出す《+『名』+『to』+『名』》
apprenticeship	徒弟(見習い)の身分;徒弟(見習い)の期間
apprise	(…を)…に通知する,警告する《+『名』+『of』+『名』》;(…だと)…に知らせる《+『名』+『that節』》
appro.	approbation; approval
approach	〈ある時間・場所・状態〉に『近づく』,接近する / (ある目的・要求で)〈人〉に近づく,交渉する《+『名』〈人〉+『on』(『about』)+『名』(do『ing』)》 / 〈研究・仕事など〉に取りかかる,〈問題など〉を扱う / 〈時・事などが〉『近づく』 / (程度・性質などにおいて)(…に)似ている,近い《+『to』+『名』》 / 〈U〉〈C〉(…に)『接近』,近づくこと《+『to』+『名』》 / 《しばしば複数形で》(ある目的で)(人に)近づくこと,取り入ること《+『to』+『名』》 / 〈U〉(…との)近似,類似《+『to』+『名』》 / 〈C〉(…へ)近づく道,(…への)入り口《+『to』+『名』》 / 〈C〉(問題・作品などの)扱い方,手引き;(…の)学習(研究)法《+『to』+『名』》
approachable	(場所が)近づくことができる,接近できる / 《話》(人が)親しみやすい,近づきやすい
approbation	賞賛 / (公式な)承認,認可,裁可
approbatory	賞賛の,ほめそやす / 認可の,承認の
appropriate	…を『勝手に使う』,独り占めにする / (ある目的に)…を『あてる』,充当する《+『名』+『for』+『名』》 / 『適当な』,適切な
appropriately	適当に,適切に,ふさわしく
appropriation	〈U〉(…の)専有,独占;(…の)盗用,横領《+『of』+『名』》 / 〈U〉〈C〉(…に)充当すること《+『for』+『名』》;〈C〉充当物(金)
appropriator	専有する人,盗用(横領)する人 / 《英》教会禄(ろく)の設定を受けた宗教法人
approval	(…に対する)『賛成』,是認《+『to』+『名』》
approve	〈事〉を『よいと認める』,に賛成する / (正式に)…を認可する,承認する / 《『approve of』+『名』(do『ing』)》(…を)承認する,賛成する
approved school	公認学校(特に児童の保護や教育を目的とした施設)
approvingly	賛成して,満足そうに
approx.	approximate[ly]
approximate	(数量の点で)『近似の』,おおよその / 《『approximate to』+『名』》(…に)『近い』,ほぼ等しい / (ある状態・量・額などの点で)…に『近づく』,接近する / (…の額に)…を概算する,見積もる《+『名』+『at』+『名』》
approximately	おおよそ,だいたい(nearly)
approximation	接近,近似 / 概算 / 近似値
appt.	appoint / appointment
appurtenance	付属物 / 従物(法律上財産に付属している権利)
appurtenant	付属の,従属する;(…に)付属した《+『to』+『名』》
apricot	〈C〉アンズ;アンズの木 / 〈U〉アンズ色 / アンズ色の,黄赤色の
apron	『エプロン』,前掛け / (また『apron stage』)張り出し舞台 / エプロン(飛行機の乗降・荷積み・給油などをする所)
apron strings	エプロンのひも
apropos	適切な / 適切に,好都合に
après-ski	スキーをした後のくつろぎの時間 / スキー後のくつろぎの時にふさわしい
apse	後陣(教会堂の東端に張り出した半円形または多角形の部分)
apt	《補語にのみ用いて》《『be apt to』 do》(望ましくないことについて)…『しがちである』(be liable to do) / 《補語にのみ用いて》《『be apt to』 do》《米話》…しそうである(be likely to do) / 『適した』,『ふさわしい』,適切な / 利発な,物覚えが早い
apt.	apartment
aptitude	(…に対する)(生まれつきの)素質,才能,適性《+『for』+『名』(do『ing』)》 / 傾向
aptitude test	適性検査
aptly	適切に
aptness	(…の)適性,才能《+『for』+『名』》 / (…する)傾向,性向《+『to』 do》
aqua	水;溶液 / 《複合語を作って》「水の…」「水に関する…」の意を表す
aquacade	水上ショー(音楽に合わせて飛込み・水中ショーなどを見せる)
aquaculture	養殖,養魚
aqualung	アクアラング(潜水用の水中呼吸器;もと商標名)
aquamarine	〈U〉〈C〉アクアマリン,藍(らん)玉(宝石の一種) / 〈U〉藍緑色(青味がかった緑色) / 藍緑色の
aquanaut	海洋潜水士(深海に設置された居住設備内に生活し,学術上のデーターをとる人)
aquaplane	水上スキー / 水上スキーに乗る
aquaregia	王水(金・白金を溶解させる混合液)
aquarium	水族館 / (魚・水生植物の飼育観察用)水そう,ガラスばち
aquatic	水生の,水の / 水上の,水中で行われる
aquatint	〈U〉アクアチント(食刻板画法の一種) / 〈C〉アクアチント版画
aquavit	=akvavit
aquavitae	(ウイスキー・ブランデーのような)強い酒
aqueduct	送水路,水路橋
aqueous	水の,水を含んだ
aqueous humor	(眼球水晶体の)水様液,眼房水
aquiculture	水耕法 / =aquaculture
aquifer	水を含む地層,(特に)井戸(泉)の水源
aquiline	ワシの / ワシのくちばしのような
ar	are (面積の単位)の変形
ar.	arrival / arrive,arrives
arabesque	アラビア風の,唐草(からくさ)模様の;風変りな / アラビア風のデザイン,唐草模様 / アラベスク(バレーのポーズの一つ) / アラベスク(アラビア風の華麗な楽曲)
arable	(土地が)耕作に適した,耕作された / 耕地,農地
arachnid	クモ類の動物(クモ,サソリ,ダニなど)
arbalest,arbalist	(中世の)強力な大弓
arbiter	(特に,労働争議の)調停者,仲裁者 / (…の)最高の権威者《+『of』(『in』)+『名』》
arbitrage	(為替・株式などの)さやとり売買;裁定取引
arbitrament	仲裁,調停;裁決;裁決権
arbitrarily	随意に,気ままに
arbitrary	随意の,任意の,気まぐれな(capricious) / 独裁的な,独断的な,専横な(despotic)
arbitrate	(…間で)…を仲裁する(settle)《+『名』+『between』+『名』》 / 〈紛争当事者双方が〉〈紛争など〉を仲裁にまかせる / (…間を)仲裁者として裁定する《+『between』+『名』》 / 紛争を仲裁に付す
arbitration	仲裁,裁定;仲裁裁判
arbitrator	(特に,労働争議の)仲裁人,調停者 / 最終決定者
arbor	(庭園の)木陰のあずまや,藤棚,緑のトンネル / (機械)回転軸,心棒
arboreal	樹木の,樹上に住む
arboretum	植物園,樹木園
arbour	(英国で)(庭園の)木陰のあずまや,藤棚,緑のトンネル
arbutus	アービュタス(シャクナゲ科の常緑低木) / 北米産イワナシ
arc	『弧』,円弧 / 電弧(2点間を弧状に流れる電流) / 弧を描く / 電弧を生じる
arc lamp(light)	アーク灯
arcade	拱廊(きょうろう)(建物の側面につけた廊下状の通路) / アーケード(両側に商店が並ぶ屋根つき街路)
arcane	神秘的な,不可思議な
arch	(建物の)『アーチ』,迫持(せりもち) / アーチ型の記念碑,弓形門 / 『弓形のもの』 / (足の)土踏まず / …を弓形にする / …にアーチをかける / 弓形になる,弓状に伸びる / 《名詞の前にのみ用いて》おもな,主要な(chief) / (おもに女・子供が)ずるそうな,いたずらそうな(mischievous)
archaeological, archeological	孝古学の,考古学的な
archaeologist, archeologist	考古学者
archaeology, archeology	考古学
archaeopteryx,archeopteryx	始祖鳥(絶滅した鳥類の祖先)
archaic	(言葉が)今は一般に用いられない,古風な,すたれた / 古代の
archaism	古語,古風な表現 / 〈U〉古文体,擬古体
archangel	(ユダヤ教・キリスト教・イスラム教の)大天使,天使長
archbishop	(カトリックの)大司教;(新教の)大監督;(ギリシア正教・聖公会の)大主教;(仏教の)大僧正
archbishopric	archbishopの職(地位,任期,教区,管轄権)
archdeacon	(英国国教の)副監督
archdeaconry	archdeaconの職(地位,任期,住所)
archdiocese	archbishopの管区
archduke	大公,(特に)旧オーストリア国皇子
arched	アーチ形の,弓形の / アーチのある
archenemy	大敵
archeological	=archaeological
