vet	=veterinarian / 〈動物〉を診療する / 《話》〈人〉を診療する / 《話》〈人・物〉を注意深く調べる / =veteran
vetch	ソラマメ,ヤハズエンドウ,カラスノエンドウ
veteran	(仕事・活動などの)『老練者』,古つわもの,ベテラン / 『古参兵』,老兵 / 《米》(また《話》vet)退役軍人,在郷軍人兵 / 使い古したもの,中古品 / (仕事に)経験豊かな,老練な / (軍事に)熟達した,経験の多い / 使い古した,中古の
veterinarian	獣医(《英》veterinary surgeon)
veterinary	家畜の病気に関する / =veterinarian
veto	〈U〉拒否権;拒否権の行使 / (またveto message)〈U〉拒否通告状,拒否教書 / 〈C〉(一般に)(…の)拒否《+on+名》 / (拒否権を行使して)〈議案など〉を拒否する / (一般に)…を拒否する,禁止する
vetoer	禁止する人,拒否する人,拒否権行使者
vex	〈人〉を『いらいらさせる』,怒らせる;悩ませる
vexation	〈U〉いらだたしさ,腹立ち,悩み / 〈C〉《しばしば複数形で》悩みの種,しゃくの種
vexatious	いらだたしい,腹立たしい,じれったい,わずらわしい
vexed question	議論の多い(やっかいな)問題,難問
vhf,VHF	very high frequency
via	『…経由で』,を経て / …によって
viability	生活力,生育力
viable	生存できる,生活できる,生育できる / 実行できる
viably	生存できるように;実行可能なように
viaduct	陸橋,高架橋
vial	=phial
viand	《通例複数形で》《大げさに》食物;ごちそう
viaticum	聖糧,臨終の聖餐(さん)(臨終のときに受ける聖体)
vibes	《通例単数扱い》=vibraphone / 《複数扱い》=vibration
vibraharp	=vibraphone
vibrancy	(色・光などの)輝き,活気,生き生きしていること
vibrant	《文》振動する,響き渡る / (色・光が)生き生きした / 活発な,精力的な
vibraphone	ビブラホン(鉄琴楽器の一種)
vibrate	『振動する』,揺れる;振動音を出す,〈音が〉反響する / 〈人・心などが〉(…で)『おののく』,どきどきする《+with+名》 / …を揺り動かす,振動させる
vibration	〈U〉震え,振動 / 〈C〉〈U〉(物理学で)振動 / 〈C〉《複数形で》(またvibes)《話》(人・状況などから受ける)感じ,直感
vibrato	ビブラート,振動[音]
vibrator	振動するもの;マッサージ用の振動器
viburnum	ガマズミ属の植物;樹皮は薬用
vicar	(英国国教の)教区牧師(rector以外の牧師でstipend を受ける) / (ローマカトリック教の)司教代理 / 《米》(監督教会の)会堂牧師 / 代理,代理者
vicar general	(ローマカトリック教会の)司教総代理(《略》V.G.)
vicarage	〈C〉vicar の住宅,牧師館 / 〈U〉vicar の職
vicarious	他人の身になって感じる,想像して味わう / 《今はまれ》他に代わってする(受ける),身代りの / 《今はまれ》代理の,代行の
vice	〈U〉悪徳,不道徳 / 〈C〉(特定の)悪徳行為;《話》悪習,悪癖 / 〈C〉〈U〉(馬・犬などの)悪癖
vice admiral	海軍中将
vice presidency	vice-presidentの職(任期・地位)
vice president	副大統領,副総裁,副総長,副会長,副社長,副頭取
vice presidential	vice-presidentの
vice regal	viceroyの
vice squad	(警察の)風紀犯罪取締班
vice versa	逆に,反対に,逆もまた同様(《略》V.V.)
vicegerent	(王・最高長官の)代理人,名代
vicelike	しっかりした,しっかりと捕えられた
vicennial	20年ごとに起こる,20年に1回の
vicereine	副王(太守)の妻
viceroy	(国王に代わって属国を支配する)総督 / 米国産タテハチョウ科のイチモンジチョウの一種
vichyssoise	ビシッソワーズ(ジャガイモとタマネギの入った濃いクリームスープ;通例冷やして供する)
vicinage	=vicinity
vicinity	〈U〉〈C〉(…の)『近所』,近辺,付近(neighborhood)《+of+名》 / 〈U〉(…に)『近いこと』,接近《+of(to)+名》
vicious	『悪意のある』,意地悪な,残忍な / (馬が)御しにくい;(他の動物が)どうもうな / 《米》ひどい,激しい / 《文・今はまれ》『悪徳の』,不道徳の,よこしまな
vicious circle	悪循環
vicissitude	(人生・境遇などの)変化,変動,浮沈
victim	(…の)『犠牲者』,被害者(物)《+of+名》 / 『だまされる人』;(…の)食いもの,えじき《+of+名》 / (神にささげる)いけにえ
victimization, victimisation	犠牲にする(なる)こと
victimize, victimise	…を犠牲にする / …をだます(cheat)
victimless crime	(売春・ギャンブルのように)同意の下に行われる違法行為
victor	『勝利者』,征服者
victoria	二人乗り四輪ほろ馬車 / victoria plum
victorious	(人・チームなどが)『勝利を得た』 / 勝利の,勝利を示す,勝ち誇った
victory	(…に対する)『勝利』,戦勝《+over(in)+名》
victual	飲食物,食料(provisions) / 〈多人数〉に食物を供給する,〈船など〉に食糧を積み込む
victualer, victualler	食糧供給者 / 《英》飲食店主
vicuna,vicuña	〈C〉ビクーナ(南米産の野生ラマの一種) / 〈U〉ビクーナ毛織
vide	(特に読者に対して参照のため)…を見よ
vide infra	(ラテン語)下を見よ(《略》v.i.)
vide supra	(ラテン語)上を見よ(《略》v.s.)
videlicet	すなわち(《略》viz.)
video	〈U〉テレビの映像 / 〈C〉テレビ / テレビ映像に関する / ビデオテープの
videodisc	ビデオディスク(家庭用のテレビ受像機で映像を再生するためのレコード型円盤)
videotape	ビデオテープ(テレビの録音と録画をする磁気テープ) / 〈テレビの映像〉を録画する
vidkid	テレビっ子
vie	争う,張り合う,競争する,《vie in+名(doing)》…を競い合う
view	〈C〉〈U〉(…を)『見ること』,ながめること,一見,一覧《+of+名》 / 〈U〉(…の)『視界』,視野《+of+名》 / 〈U〉《しばしばa ~》(…の)『ながめ』,光景,けしき《+of+名》 / 〈C〉(…の)風景画(写真)《+of+名》 / 〈C〉《しばしば単数形で》『見方』,考え方,見解 / 〈C〉意図
viewer	テレビを視聴者 / 観察者,見物人 / ビューアー(スライド・標本などを拡大して見る装置)
viewfinder	(写真機の)ファインダー
viewless	意見のない
viewpoint	『観点』,見地,見解(point of view)
vigesimal	20を基礎にした,20進法の
vigil	〈U〉〈C〉不寝番,徹夜で見守ること / 《the ~》《古》祭りの前夜
vigilance	警戒,用心
vigilant	(危険に備えて)油断のない,用心深い
vigilante	自警団員
vignette	(書物の章頭・章尾などの)飾り模様(カット) / ビネット(背景をぼかしにした頭部と肩だけの写真または絵) / 小品文,スケッチ
vigor, vigour	(精神的・肉体的な)『力強さ』,精力,活力 / (論旨・文体などの)強さ,迫力
vigorous	(人が)『精力的な』,元気な;(行動などが)活気がある,力強い
vigorously	精力的に,元気よく,活発に,力強く
vigour	=vigor
vile	『下劣な』,堕落した,不道徳な / 身分の卑しい,みじめな / 《話》ひどく不快な;ひどく悪い
vile.	village
vilification	悪く言うこと,けなすこと;〈U〉そしり,悪口
vilify	〈人・事〉を悪く言う,けなす
villa	(特に南欧の)別荘 / 郊外住宅
village	〈C〉村,村落 / 《the~》《集合的に;複数扱い》『村の人々』,村民
villager	村人
villain	『悪者』,悪漢,悪党 / (劇・小説などの)悪役,かたき役 / 《おどけて》小僧,やつ / 《英話》犯人 / =villein
villainous	《おもに文》悪人の;極悪の / 《話》ひどく悪い,お話にならない
villainy	〈U〉極悪,邪悪 / 〈C〉《複数形で》悪事,悪行
villein	(中世の)農奴
villeinage	農奴の身分(地位)
