vitamin E	ビタミン E
vitamin G	=vitamin B2;かつて使用されたがのちにvitamin B2と同じものと分かり廃止
vitamin H	=biotin ビタミンH
vitamin K	ビタミン K
vitamin P	ビタミン P
vitamin-B complex	ビタミン B 複合体(イースト・肝臓に含まれ,ビタミン B1,B2,B6,B12,H,その他ナイアシン,ビオチン,葉酸などから成る)
vitiate	《しばしば受動態で》…を悪くする,損う / (法律的に)…を無効にする
vitiation	損うこと;(法律的に)無効にすること
viticulture	ぶどう栽培
vitreous	ガラスの;ガラス製の;ガラス状の
vitreous humor	(眼球の)ガラス体液(眼球を満たしている水状の物質)
vitrify	…をガラス[状]にする / ガラス[状]になる
vitriol	(銅・鉄・亜鉛・鉛などの)硫酸塩,はん類 / (また oil of vitriol)硫酸(sulfuric acid) / しんらつな言葉,痛烈な皮肉
vitriolic	硫酸[塩]の,硫酸からできる / しんらつな,痛烈な
vituperate	《文》…を厳しく避難する,ののしる
vituperation	厳しく避難すること,ののしり
vituperative	厳しく避難する,毒舌をふるう
viva	…万歳
vivace	(音楽で)活発に,速く / (音楽が)活発な,速い
vivacious	(特に女性が)快活な,元気な,陽気な
vivacity	活発さ,陽気
vivarium	生態動物園(動物が自然に近い状態で飼育されている)
vivid	(色・光が)『あざやかな』,目のさめるような,強烈な / 『鮮明な』,明りょうな / (描写などが)『真に迫っている』,生き生きとして / 元気,生気にあふれる
vividly	あざやかに;はっきりと;生き生きと
vividness	鮮明,明りょう / 生気,はつらつ
vivify	…に生命(生気)を与える,…を生き生きさせる
viviparous	(動物が)胎性の
vivisect	〈動物〉を生体解剖する / 生体解剖をする
vivisection	生体解剖
vixen	雌ギツネ / がみがみ女
viz.	すなわち
vizier, vizir	(イスラム教国の)高官,大臣
vizor	=visor
vl	Vulgar
vlf,VLF	very low frequency
vocab.	vocabulary
vocable	音語(意味に関係なく音と文字からみた語) 単語 母音 発声できる
vocabulary	〈C〉(特定の人・グループ・分野で用いられるすべての)『語彙』,用語 / 〈C〉(アルファベット順に並べて語義や訳を付けた)語彙集,単語表(集) / 〈U〉(一言語の)全語彙
vocal	『声の』,音声の / 声に出す,口頭の / 《話》(意見などを)遠慮なくしゃべる,口やかましい / (ポピュラー歌手の)ボーカル
vocal cords, vocal chords	声帯
vocalic	母音の,母音を含む / 母音のような
vocalist	(ポピュラーソングの)歌手
vocalize, vocalise	〈言葉・音声など〉を声に出す,歌う / 〈子音〉を母音に変える / 声を出す,歌う,発声練習をする
vocat.	vocative
vocation	〈C〉(特に,自分に適した,またはその訓練を受けた)職業 / 〈U〉《時にa~》(特定の職業・仕事に対する)適性,素質《+for+名(doing)》 / 〈U〉《しばしば a~》天職,使命
vocational	職業の,職業上の / 職業指導の
vocational school	職業学校,職業訓練所
vocative	呼格の(人・物に対する呼び掛けとして用いる名詞の格に関していう;《略》vocat.) / 呼格,呼び掛けの語
vociferate	〈言葉〉を大声で話す,叫ぶ / 大声で叫ぶ,わめく
vociferation	大声で叫ぶこと,わめき
vociferous	大声で呼ぶ,やかましい / (態度が)口うるさい
vodka	ウォッカ(無色透明で穀物やじゃがいもから作るロシアの火酒)
vogue	〈C〉(ある時期の)(…の)『流行[品]』,はやり[もの]《+for+名》(fashion)
voice	〈U〉(人間の)『声』 / 〈U〉声を出す力,物を言う力 / 〈C〉〈U〉声の質,声の状態(調子) / 〈C〉(人の声を思わせる)(…の)音《+of+名》 / 〈C〉(人の声にたとえた)(…の)音《+of+名》 / 〈U〉〈C〉『発言権』,選択権,投票権 / 〈U〉表現,表明;意見 / 〈C〉(声楽の)声 / 〈C〉(文法で)態 / 〈気持ちなど〉を言い表す,口に出す / 〈音〉を有声音で発音する
voice box	喉頭(こうとう)(larynx)
voiced	言い表された,口に出された / 有声音の,有声の
voiceless	声のない,口がきけない,無言の / (子音が)無声音の / 意見を言えない(言わない)
voiceover	(テレビ・映画などの)ナレーターの声(語り)
voiceprint	声紋(声の特徴を表す音響分析図)
void	(法的に)『無効な』 / 《文》『空虚な』,からっぽの / 《補語にのみ用いて》《be void of+名》(…が)『ない』,欠けた / 〈U〉《the ~》(地球の回りの)『空間』,空所,虚空 / 〈C〉《単数形で》(地面・壁などの)すきま,割れ目 / 〈C〉《単数形で》『空虚感』,物足りなさ / (法的に)…を無効にする / …をからにする;…を排泄(はいせつ)する
voile	ボイル(木綿・羊毛・絹・レーヨン製の薄織物)
vol.	volume
volatile	(液体が)揮発性の,揮発しやすい / (人・性格が)変わりやすい,気まぐれの / 不安定な;爆発しやすい / 怒りやすい,短気な
volatility	揮発性 / 移り気,気まぐれ
volcanic	火山の,火山性の / 火山爆発による,火山から噴出した / 激しい,猛烈な(violent)
volcanism	火山作用,火山現象
volcano	『火山』
volcanology	火山学
vole	ハタネズミ(mouseやratの類だが尾の短いのが特色)
volition	意志,決意
volitional	意志の,意志による,意欲的な
volley	(ミサイル・弾丸・矢・石などの)一斉射撃《+of+名》 / (悪口・質問・抗議などの)連発《+of+名》 / (テニス・バレーボールで)ボレー(ボールが地面に落ちる前に打ち返すこと) / 〈矢・弾などが〉一斉に飛ぶ,〈火器が〉一斉に発射される / (テニス・バレーボールで)ボレーする / 〈相手〉にボレーで打ち返す
volleyball	〈U〉『バレーボール』,排球 / 〈C〉バレーボール用のボール
volt	ボルト(電圧の単位;《略》V;イタリアの物理学者 Alessandro Volta(1745‐1827)の名にちなんで)
voltage	電圧,電圧量,ボルト数
voltaic	(化学作用によって生じた)電流の / (化学作用によって)電流を生じる
volte-face	(意見・政策などの)転向,逆転,急変
voltmeter	電圧計
volubility	舌のよく回ること,おしゃべり
voluble	舌のよく回る,おしゃべりな
volume	〈C〉(特に分厚い)『本』,書物 / 〈C〉(シリーズものの)『巻』,冊(《略》(単数形で)vol.,(複数形で)vols.) / 〈U〉(…の)『体積』,容積《+of+名》 / 〈U〉〈C〉(…の)『量』,かさ《+of+名》 / 〈U〉(…の)『音量』,音の強さ,ボリューム《+of+名》 / 《複数形で》多量(の…),たくさん(の…)《+of+名》
voluminous	おびただしい量の / (容器が)容積の大きい,たっぷりはいる / (服などが)ゆったりした,だぶだぶの
voluntarily	みずから進んで,自発的に
voluntary	(強制ではなく)『自由意志でなされる』 / (報酬なしで)『みずから進んでする』,自発の / (生理学で)随意の / 《名詞の前にのみ用いて》篤志によってできた,任意寄付で維持される / (教会の礼拝前後の)オルガン独奏
volunteer	(…の)『志願者』,有志《+for+名(doing)》 / 『志願兵』,義勇兵 / (…を)自発的にやろうとする,(…に)志願する《+for+名(doing)》 / …を自発的に申し出る / 有志の,志願の,自発的な,
voluptuary	享楽者,酒色におぼれる人
voluptuous	享楽的な酒色におぼれる / 肉感的な,なまめかしい / 肉欲にふける; セクシーな; 官能的な 感覚的に快い
vomit	(胃から)吐く,もどす / 〈煙・灰などが〉吹き出る,吐き出される / 〈胃の中のもの〉を吐き出す / (勢いよく)…を噴出する,吹き出す / 〈U〉吐いた物,嘔吐物 / 〈C〉へどを吐くこと
von	…から(from),…の(of)
voodoo	〈U〉ブードゥー教(西インド諸島やアメリカの一部の黒人間で行われる,まじないを信仰する宗教) / 〈C〉ブードゥー教のまじない師;ブードゥー教のまじない / ブードゥー教の
voodooism	ブードゥー教の儀式(呪術)
voracious	むさぼり食う,大食する
voracity	大食,猛烈な食欲;どん欲さ
vortex	〈C〉うず,うず巻き;旋風 / 《the~》《文》《比ゆ的に》(…の)うず《+of+名》
vortices	vortex の複数形
votary	《文》(思想・主義などの)追求者,支持者,研究者 / (特定の神・宗教の)信奉者,信者
vote	〈C〉『票』 / 〈C〉『投票』;(投票・挙手・起立などの)意志表示 / 〈C〉(…に関する)(投票・挙手・起立などによる)『決定』,票決《+on(about)+名》 / 《the vote》《時に複数形で》『投票権』,選挙権 / 《the vote,時に a vote》《集合的に》投票数,得票[数] / 投票する / 〈人〉に『票を入れる』,投票する / 〈法案・予算など〉を可決する / 《vote+名+名〈補〉》《話》《しばしば受動態で》世間が一致して…を(…と)見なす / 《vote+that 節》《話》…することを提案する
vote of censure	不信任投票
voter	投票者;有権者
votive	(誓いを果たすために)奉納した;祈願を込めた
