undergarment	下着,肌着
undergird	…にしっかりした基礎を与える,を強化する
undergo	〈変化・検査など〉を『受ける』,経験する(experience) / 〈困難など〉に耐える,あう
undergone	undergo の過去分詞
undergraduate	大学生,学部在学生 / 学部学生の
underground	『地下の』 / 《比喩的に》『地下の』,秘密の,隠れた / (運動・映画・出版物などについて)前衛的(実験的)な,アングラの / 『地下に(で)』 / 秘密のうちに,隠れて / 〈C〉(政府や占領軍に反抗する)『地下秘密組織』 / 《英》《the ~》『地下鉄』
undergrowth	(林などの)下ばえ
underhand	(野球などで)下手投げの / 秘密の,ずるい / 下手投げで / こそこそとずるく,陰険に
underhanded	=underhand
underhung	(下あごが)上あごよりも突き出た (建築)下受け式の
underlay	(品質の維持と保温のためにカーペットの下に敷く)下敷き
underlie	…の下に横たわる,下にある / 〈行動・理論など〉の基礎となる,根拠となる
underline	〈語句〉に『下線を引く』 / …を強調する / (強調または斜体字を示す)下線,アンダーライン
underling	部下,下役,手下
underlying	下にある,下に横たわる / 基礎的な,基本的な
undermanned	(船が)通常の人員を欠いている / (職場などに)人手が足りない,要員不足の
undermentioned	下記の,後述の
undermine	…の下を掘る,下に穴(トンネル)を掘る / (浸食作用で)…の土台を壊す(削る) / 〈健康・名声など〉を知らないうちに(徐々に)害する,弱める
undermost	最下位の,最低の / 最下位で,最低で
underneath	…『の下に(を)』 / …の見かけのもとで / 『下に』,下の方に / 底,下側;最下部
undernourish	…に十分の栄養を与えない,を栄養不足にする
undernourished	栄養不足(不良)の
undernourishment	栄養不足(不良)
underpants	パンツ,ズボン下
underpart	(物の)下部,下側;(動物の)腹部
underpass	(鉄道・橋・道路の下を通る)地下道,ガード下通路
underpay	〈労働者など〉に賃金を十分に支払わない,不当に安い給料を払う
underpin	(支柱・けたなどで)…を下から支える,に基礎(根拠)を与える《+名+with(by)+名》
underpinning	(壁や建造物などを)下から支えるもの(石,コンクリート,柱など);土台,基礎 / 支持,支援;支援物質
underplay	〈役〉を押えて演じる;〈場面など〉を控え目に表現する / 控え目に演技する
underpopulated	(土地の)人口が少ない,人口不足の
underprivileged	(社会的・経済的・肉体的に)恵まれない / 《the underprivileged》《集合的に》《複数扱い》恵まれない人々
underproduction	低生産(通常以下また需要より少ない生産)
underproof	(酒が)標準強度以下の(標準強度の酒(米で50%,英で57%)よりもアルコール含有分の少ない)
underquote	(特定の競争相手よりも)…に安い値をつける,を安く見積もる(underbid)
underrate	〈人・能力・物事〉を過小評価する,見くびる
underscore	=underline
undersea	海中の / =underseas
underseas	海中に(を)
undersecretary	次官
undersell	〈競争相手〉より安く売る;〈品物〉を投げ売りする
undersexed	性にあまり関心を示さない,性欲の弱い
undershirt	《米》肌着,シャツ(《英》vest)
undershoot	〈飛行機が〉〈滑走路〉の手前で着陸する / 〈弾丸・矢などが〉〈目標・的〉まで達しない
undershorts	(男子・子供用の)パンツ
undershot	undershoot の過去・過去分詞 / (水車が)下を流れる水で回転する / 下あごが上あごより突き出た
underside	下側,下面,底面
undersigned	(書類の)末尾に署名した(された) / 署名人,署名者
undersized	普通より小さい,小型の
underskirt	アンダースカート(スカートの下にはくもの;ペチコートなど)
underslung	(自動車の車台などが)懸下式の,重心の低い
understaffed	職員(人員)の不足した
understand	〈事〉を『理解する』,の意味をつかむ / 〈人〉を理解する,の気持ち(立場)が分かる / 〈物事〉に『精通している』,をよく知っている / …と推測する,思う:《understand+名+to do》…が…すると思う / 《understand+that 節》…であると聞いている / 『理解する』,意味をつかむ(が分かる) / 聞いている / 人の立場を理解する
understandable	分かりやすい,理解できる
understandably	理解できるように,むりもない話だが
understanding	〈U〉(…の)『理解』,意味をつかむこと《+of+名》 / 〈U〉《しばしば an~》(…に)『精通』,熟達《+of+名》 / 〈U〉『意見』,結論 / 〈U〉《時に an~》(相手の立場の)共感;〈C〉《単数形で》同意,一致 / 〈U〉『理解力』,知力,知性(intelligence) / 相手の立場を理解している,思いやりのある,話せる
understate	…を控え目(内輪)に言う
understatement	控え目(内輪)に言うこと;〈C〉その言葉・控えめな言葉[表現] 《誇張表現の反対で,控えめに表現してかえって強い印象を与える表現方法》
understood	understandの過去・過去分詞 / 了承された,合意された / (文中で)省略されているがそれと分かる(例えば He is older than my father [is].の文の[is]のこと);言外の,暗黙の
understudy	代役の俳優 / 〈役〉を代役としてけいこする / 〈別の俳優〉の代役を演ずる
undersurface	下面,底面 / 水面下の,水中の
undertake	〈仕事など〉に『着手する』 / 〈仕事など〉を『引き受ける』 / 《undertake+that 節》…であることを保証(断言)する
undertaker	(また《米》mortician)葬儀屋 / (1とアクセントの違いに注意)引受人,請負人
undertaking	〈C〉『事業』,企業,仕事 / 〈C〉約束,保証 / 〈U〉葬儀屋業
underthings	女性用下着(underclothes)
undertone	低音;小声 / 抑えた(隠された)感情 / 柔らかな(薄い)色,かすかな基調色
undertook	undertake の過去
undertow	引き波,海面下の逆流
undervalue	…を実際の価値よりも低く評価する / …を軽視する,見くびる
underwaist	アンダーウエスト(他のブラウスの下に着るブラウス) 下着を留めるブラウス
underwater	水面下の,水中の / 水面下に(を),水中で(を)
underwear	下着,肌着
underweight	重量不足の / 標準以下の重量
underwent	undergoの過去
underworld	暗黒街,悪の世界 / 《しばしば U-》(ギリシア,ローマの神話の)あの世,冥土
underwrite	…の費用負担を承諾する / 〈保険証書〉に署名する / …に保険をつける / 《おもに過去分詞形で》…の下に書く;〈文書など〉に署名する / 〈株式・債券など〉を引き受ける / 保険業を営む
underwriter	保険業者 / 証巻引受業者
undeserved	(賞罰・批判などを)受けるに値しない,不当な
undesirable	好ましくない,望ましくない / 好ましくない人
undetected	見つけられない,発見されない
undeveloped	(肉体・精神が)未発達の / (土地などが)未開発の,未発展の
undies	(特に婦人用の)下着
undigested	消化されない
undignified	威厳のない,品位のない
undischarged	(船の積み荷が)荷揚げされていない / (銃が)未発射の / (勘定・借金が)未払いの / (法的に)返済不履行の
undisciplined	訓練を受けてない;規律を守らない
undiscovered	発見されていない,未知の
undisguised	あからさまの,むき出しの
undisputed	異論(疑問)の余地のない
undistinguished	区別されない;有名でない,平凡な
undisturbed	乱されない,じゃまされない;静かな
undivided	(比較変化なし)分裂(分割)していない,欠けたところのない
undo	〈結び目など〉を『開く』,ゆるめる,〈ボタンなど〉をはずす / 〈包みなど〉を『開ける』;〈かんぬきなど〉をはずす / 〈一度やったこと〉を『元どおりにする』,取り消す / 《文》《しばしば受動態で》…を破滅させる,だめにしてしまう
undoing	(一度したことを)元どおりにすること,取り消し / 破滅,没落 / 破滅の原因
undomesticated	(動物が)飼いならせない,人になれない / (人が)家庭的でない
undone	undo の過去分詞 / 解いた,ほどいた,ゆるめた / してない,未完の
undoubted	疑いのない,確かな
undoubtedly	疑いなく,確かに
undreamed-of	夢にも思わない
undress	…を着物を脱がせる / 着物を脱ぐ / (礼服に対して)平服,ふだん着 / はだか
