growler	うなる人(動物)
grown	growの過去分詞 / 成長した,大きくなった / 《複合語を作って》「…の茂った」「…産の」の意を表す
grownup	『成長した』,成人した / 『おとならしい』,おとなに適した / 『おとな』
growth	〈U〉(…の)『成長』,発育;『発達』,発展《+『of』+『名』》 / 〈U〉(数・量,重要性・力などの)『増加』,増大,拡張《+『of』+『名』》 / 〈U〉《修飾語[句]を伴って》栽培,生産,…産 / 〈C〉成育した物,(草,木,髪,ひげなどの)生えたもの / 〈C〉腫瘍(しゅよう)
grub	〈木・草の根〉を掘り起こす,根こそぎにする《+『up』(『out』+『名』,+『名』+『up』(『out』)》 / 掘る,掘って捜す《+『around』(『about』)》 / あくせく働く / ウジ,昆虫の幼虫 / 〈U〉《話》食い物)
grubbily	汚く,汚れて
grubbiness	汚さ,汚れていること
grubby	汚い
grubstake	《集合的に》(鉱脈を見つけたときに利益を分けてもらうことを条件として)試掘者に与える食糧・道具類 / 新しく事業を始める人に与える物質的援助 / 〈新しく事業を始める人〉に物質的援助を与える
grudge	(…に対する)『恨み』,遺恨《+『against』+『名』》 / …を『与えるのを惜しむ』
grudging	不本意の,いやいやながらの / けちけちした,しみったれの
gruel	(湯または牛乳で料理したオートミールなどの)薄いかゆ
grueling,gruelling	疲れ果てさせる,ひどく厳しい
gruesome	恐ろしい,ぞっとする
gruff	(声が)荒々しい,しわがれた / (人・行動が)ぶっきらぼうな,つっけんどんな,無作法な
grumble	(人に…について)『不平』(『不満』)『をいう』《+『at』〈人〉+『名』+『about』(『over』)+『名』》 / 〈雷などが〉ゴロゴロ鳴る / …をぶつぶつ言う / 『不平』 / (雷などの)ゴロゴロ[鳴る音]
grumbler	ぶつぶつ不平を言う人
grumbling	(虫垂が)不調な,痛む,すっきりしない
grumpy	むっつりとした,気難しい
grunge	不潔なもの、汚いもの / (ファッションで)グランジ (わざと汚れた感じにする); グランジロック (わざと汚い格好で演奏する:シアトル発祥・音も汚いです:Nirvana、Pearl Jamなどが代表)
grunion	イワシ科の食用魚
grunt	〈豚が〉ブーブー鳴く / 〈人が〉ブーブー言う / …をぶつぶつ言う,不平がましく言う / ブーブー言う声
gryphon	=griffin
gt.	great
guacamole	ガカモーリ(アボカド・コショウのきいたメキシコのソース)
guano	グアノ(海鳥のふんのたい積したもので,肥料になる)
guarani	グアラニー(パラグアイの貨幣単位)
guarantee	(またguaranty)(商品に対する品質・修理・期間などの)『保証』;『保証書』 / =guaranty1,2 / 保証を受ける人,被保証人 / =guarantor / 〈商品・品質,契約の履行など〉を『保証する』,請け合う
guarantor	保証(担保)人,引受け人
guaranty	保証;保証書 / 担保,担保物件 / =guarantee 1 / …を保証する(guarantee)
guard	〈C〉『見張り』,番人;歩哨(ほしょう),番兵;護衛兵 / 〈U〉(…を)見張ること,監視すること《+『over』+『名』》;(…を)警戒(用心)すること《+『against』+『名』》 / 〈C〉《英》(列車・電車の)『車掌』(《米》conductor) / 《the Guards》《英》近衛(このえ)連隊 / 〈U〉〈C〉(ボクシング・フェンシングなどで,相手の攻撃に対する)ガード,防御 / 〈C〉(米式フットボール・バスケットボールの)ガード / 〈C〉《しばしば複合語を作って》「(危険などを)防止する物,保護物」の意を表す / …を『見張る』,環視する / (…から)…を『警戒する』,守る《+『against』(『from』)+『名』》 / (…に備えて)『警戒する』,用心する《+『against』+『名』(do『ing』)》
guarded	(特に発言が)用心深い,慎重な(cautious) / 保護された,環視された
guardhouse	衛兵所 / 留置所
guardian	『保護者』,監視人,管理者 / (未成年者などの)後見人
guardian angel	(個人・社会・地方の)守護天使・大いに援助してくれる人・守護神・(親のいない子の)後見人
guardianship	後見人の身分(役目,期間)
guardrail	(階段などの)手すり,(事故防止などのための)ガードレール / (また『checkrail』)(脱線防止用の)補助レール
guardroom	衛兵所の部屋,衛兵詰所
guards van	=caboose
guardsman	番人,番兵(guard),環視員 / 《米》州兵 / 《英》近衛(このえ)兵,近衛士官
guava	バンジロウ[の実](うす桃色の実をつける小さな熱帯樹)
gubernatorial	総督の;(米国の)州知事の
gudgeon	セイヨウカマツカ(釣りやすいコイ科の淡魚;釣りえ,および食用)・《英》だまされやすい人,かも
guerdon	報い,報賞
guerrilla theater	ゲリラ劇場(戦争反対を寸劇で見せる街頭演劇)
guerrilla,guerilla	ゲリラ兵,遊撃兵 / ゲリラの
guess	(十分な根拠なしに)…を『推測する』,推量する / (正確な推測で)…を『言い当てる』,判断する / 《『guess』+『that節』》《米》…と『思う』(think, suppose),信じる(believe) / (…を)『推測する』《+『at』(『about』)+『名』》 / (…についての)『推測』,推量《『at』(『about, as to』)+『名』(『wh-節』)》
guesswork	当て推量,当てずっぽう
guest	(食事・会合・滞在などへの)『招待客』,賓客・(ホテル・下宿などの)泊まり客,宿泊人,(レストランなどの) / (ラジオ・テレビなどの番組の)ゲスト,特別出演者 / (テレビなどに)ゲスト出演する《+『on』+『名』》
guesthouse	《米》迎賓館;貸し別荘 / 《英》[高級]下宿
guestroom	(家庭の)来客用寝室,(ホテルなどの)来客室
guffaw	(下品な)ゲラゲラ笑い[擬声語] / ゲラゲラ笑う,ばか笑いをする
guidance	『指導』;『案内』;指揮 / (児童・生徒の)指導,ガイダンス / (宇宙船・ミサイルなどの)誘導[装置]
guide	〈人〉を『案内する』 / (…のことで)〈人〉に『助言する』,を指導する,導く《+『名』+『in』+『名』》 / 〈仕事・行動など〉を『監督する』,管理する;…を思い通りに動かす,支配する / 『指導者』,『案内人』,ガイド / 『指標』,道しるべ;規律 / 『旅行案内』[『書』];(…の)『手引き』,入門書《+『to』+『名』》 / 誘導装置,(外科用探針の)導子 / 《英》Girl Guidesの一員
guidebook	案内書,旅行案内
guided missile	誘導兵器,誘導弾
guideline	(未来の行動の)指針,指標《+『of』(『for』)+『名』》
guidepost	道標,道しるべ / (物事の)指針
guideword	=catchword2
guidon	〈C〉(軍隊の)部隊旗 / 小旗(特に騎兵や部隊の位置を示す旗)/ 〈C〉旗手(特に軍の小旗を持つ兵士)
guild	(中世の)ギルド / (一般に)同業組合,組合,協会
guilder	ギルダ(オランダの銀貨および貨幣単位)
guildhall	(中世の)ギルド集会所;同業者集会所・市公会堂,市ホール;《the G-》ロンドン市庁
guile	悪知恵,ずるさ,こうかつ
guileful	ずるい,悪知恵の働く,こうかつな
guileless	正直な,率直な,素朴(そぼく)な
guillemot	北部海域に住むウミバトの類の海鳥
guillotine	ギロチン,断頭台 / (紙などの)裁断機 / 断頭台で…の首を切る / [紙など]を裁断機で切断する
guilt	『有罪』;『罪』;犯罪[行為] / 罪の意識,やましさ
guiltily	罪を犯して;罪ありげに,心やましく
guiltiness	罪のあること,有罪;やましいこと
guiltless	無罪の,潔白な;(…の)罪のない《+『of』+『名』》
guilty	『罪を犯した』 / 『有罪の宣告を受けた』 / やましい,身に覚えのある
guinea	《英》ギニー金貨(昔の英国金貨で21shillingsの価値があった) / ギニー(21shillingsに当たる英国の計算上の貨幣単位;1971年に廃止)
guinea fowl	ホロホロチョウ
guinea hen	ホロホロチョウの雌 / (雌雄を区別せず)ホロホロチョウ
guinea pig	テンジクネズミ(実験材料;marmotとは別の動物)
guipure	ギピュールレース(リンネル・絹製の大柄模様の厚手のレース)
guise	外観,様子 / 見せかけ,うわべ
guitar	『ギター』
gulch	峡谷
gulden	=guilder
gulf	『湾』 / 《詩》深いふち,深淵(えん) / (地位・立場・教養・感情などの)大きな隔たり,越え難い溝
gull	カモメ / 〈人〉をだます,…をだまし取る;〈人〉をだまして(…)させる《+『名』〈人〉+『into』do『ing』》;〈人〉をだまして(…を)取る《+『名』〈人〉+[『out』]『of』+『名』》 / だまされやすい人,まぬけ
gullet	食道 / のど(throat)
gullibility	だまされやすいこと,まぬけぶり
gullible	だまされやすい;ばか正直な
gully	流水でできた小さな谷 / 溝,側溝,下水
gulp	〈飲み物・食べ物〉を急いでごくりと飲む,ぐっと飲む《+『down』+『名,』+『名』+down》 / あおる,ごくりと飲む / (…を)ごくりと飲むこと;ごくりと飲む音(量)《+『of』+『名』》
gum	〈U〉ガム,ゴム(植物から分泌される乳状の液(水に溶け,空気中で凝固する) / 〈U〉ゴムのり / 〈U〉=chewing gum / =gum tree / 〈U〉目やに / …にゴムを塗る;…をゴムのりでつける / ゴムを分泌する;〈樹木が〉やにを出す / 歯ぐき / ちえっ!畜生!)
gum Arabic	アラビアゴム
gum resin	ゴム樹脂
gum tree	ゴムの木(ユーカリなどゴム質を分泌する木)
gumbo	〈U〉ガンボ(オクラを入れたルイジアナ州のシチュー料理) / 〈C〉オクラ(米での俗称) / 〈U〉ぬかるみ / 泥土(特に粘土質の土壌)
gumboil	歯肉膿瘍
gumboots	ゴム長靴
gumdrop	ガムドロップ(ゼリー菓子の一種)
gummy	ゴムの;ゴムのような / ねばねばする
gumption	独創力,くふうに富むこと / 勇気,元気,胆力
gumshoe	ゴム靴;《複数形で》スニーカー / 《俗》刑事,探偵(たんてい)
