diner	食事をする人,正餐(せいさん)客 / 《米》=dining car / (食堂車を固定し,あるいはこれに似せた)簡易食堂
dinette	(家の中の)小食堂
ding	〈鐘など〉をガンガン鳴らす / 〈鐘などが〉ガンガン鳴る / (鐘の)ガンガン鳴る音
dingaling	うすのろ,まぬけ
dingdong	ゴーンゴーン(ガンガン)という鐘の音 / (鐘の音に似た)繰り返し鳴る音
dinghy,dingey	小舟;艦載小艇
dingily	くすんで,薄汚く
dinginess	黒ずんでいること,薄汚さ
dingle	(樹木の茂った)小峡谷
dingo	ディンゴ(オオカミに似た野犬;オーストラリア産)
dingus	なんとかいう物(人)
dingy	黒ずんだ,くすんだ,薄汚い,陰気な
dining car	食堂車
dining room	『食堂』
dining table	食卓
dink	ドロップショット(ネット上すれすれに打つテニスの打法)
dinkum	本物の,真正の;正直な
dinky	《米話》取るに足りない / 《英話》こぎれいな,かわいい
dinner	〈C〉〈U〉(1日の食事の中で)『主要な食事』,正餐(せいさん);(現在では,特に)『夕食』,晩餐 / 〈C〉(公式の)晩餐会 / 晩餐(用)の
dinner bell	ディナーベル(正餐の準備が整ったことを知らせるベル)
dinner jacket	ディナージャケット(タキシード)
dinner service	正餐用食器類一式
dinner table	正餐用食卓
dinnerware	食器類
dinosaur	恐竜(中生代の巨大な爬虫類(はちゅうるい)動物の総称)
dint	(打ってできた)くぼみ,へこみ(dent) / (たたいて)…をへこます(dent)
diocesan	司教(主教)監督管区(diocese)の
diocese	司教(主教)監督管区(イングランドでは43の監督管区から成る)
diode	ダイオード(整流器として使われる二極真空管,または半導体)
diopter	ジオプトリー(レンズの屈折力の大きさを示す単位)
diorama	ジオラマ,透視画,立体模型;立体模型館
dioxide	二酸化物
dip	(水などに)…を『ちょっと浸す』,さっとつける《+『名』+『in』(『into』)+『名』》 / (中の物を取り出すために)(…に)〈手・バケツ・ひしゃくなど〉を入れる《+『名』+『into』+『名』》 / …を浸して染める / (…から)…をすくい出す,くみ出す,すくい上げる《+『名』+『from』(『out of』)+『名』》 / 〈旗など〉をちょっと下げてまたすぐ上げる / (…に)『ちょっとつかる』,さっと潜る《+『into』+『名』》 / 下がる,沈む / 〈土地・道路などが〉下に傾く / (液体や容器に)手(さじなど)を突っ込んで取り出す《+『into』+『名』》 / (ある問題を)ちょっと調べる,のぞく;(本などを)拾い読みする《+『into』+『名』》 / 〈C〉《話》ちょっと浸す(浸る)こと,一浴び / 〈C〉(スープなどの)一すくい;一くみ / 〈U〉(クラッカーを浸す)味付けソース;(染色などの)浸液;(羊を洗う)消毒液 / 〈C〉(土地・道路の)傾斜,下り坂;沈下,くぼみ / 〈C〉(値段の)下落
diphtheria	ジフテリア(呼吸困難を起こすのどの病気)
diphthong	二重母音
dipl.	diplomat / diplomatic
diploid	(生物の染色体が)二倍性の,倍数の / 二倍体(半数染色体を二組持つ生物体・組織)
diploma	(大学・専門学校などの)卒業証書,修了証書 / (一般に)免許状,特許状,賞状 / 《複数形で》古文書
diplomacy	外交 / 外交的手腕,人扱いの手腕,駆け引き
diplomat	外交官;外交家 / 駆け引きのじょうずな人
diplomate	〈C〉専門医 / 資格認定者《米》
diplomatic	《名詞の前にのみ用いて》『外交の』,外交上の / 外交的手腕のある,駆け引きのうまい / 古文書学の
diplomatic immunity	(関税・捜索・逮捕などを免除される)外交官特権
diplomatically	外交上 / 外交的に;如才なく
diplomatics	古文書学
diplomatist	外交的手腕のある人 / 《まれ》=diplomat
dipole	(物理・電気で)双極子
dipper	ひしゃく,しゃもじ / 《the 『D-』》北斗七星(the Big Dipper);小北斗七星(the Little Dipper)
dippy	気がふれた,ばかげた
dipsomania	(発作性の)飲酒癖,アルコール中毒
dipsomaniac	飲酒狂
dipstick	計深棒(内燃機関内の油の深さを測る棒)
dipswitch	ディップスウィッチ(車のヘッドライトの光を下方の下げる装置)
dipterous	(昆虫が)双翅(そうし)目の
dire	恐ろしい,ものすごい;不吉な / 差し迫った(urgent);極端な
direct	『まっすぐな』,一直線の(straight),直進する / (列車などが途中駅に寄らずに)直行 / 直系の / 『直接の』,じかの / 『率直な』,単刀直入の / 全くの,絶対の / 原典どおりの / 『まっすぐに』,直行で / 〈事〉を『指揮する』,監督する / 《文》〈人〉に『命令する』,指図する / 〈人〉に(…への)『道を教える』《+『名』〈人〉+『to』+『名』》 / (…に)〈目・注意・努力など〉を『向ける』《+『名』+『to』(『at, toward』)+『名』(do『ing』)》 / 〈音楽・演劇・映画など〉を『指揮する』,演出する,監督する / (…に)〈手紙など〉をあてる《+『名』+『to』+『名』》
direct action	直接行動,実力行使
direct current	(電気の)直流(《略》D.C.,DC,d.c.,dc)
direct evidence	直接証拠
direct mail	ダイレクトメール(直接個人あてに送られる宣伝物などの郵便物)
direct method	直接教授法(母国語を使わない外国語教授法)
direct narration	=direct speech
direct object	直接目的語
direct primary	直接予選会(党員が直接選挙で候補者を選出する予選会)
direct proportion	正比例
direct speech	直接話法
direct tax	(所得税などの)直接税
direction	〈C〉〈U〉『方向』,方角;方面 / 〈C〉(思想・行動の)『傾向』,(事態が向かう)方向,(情報の)線 / 〈U〉『監督』,管理;指揮,指導 / 〈C〉《通例複数形で》(…についての)『指示』,指図,命令《+『for』(『about』)+『名,』+『asto』『名』(『wh-句』)》 / 〈U〉(音楽・演劇・映画などの)『指揮』,演出,監督
direction finder	方向探知器
directional	方向上の,方向を示す / (無線の電波が)指向性の
directive	指令,命令,訓令 / 指導的な,指示的な
directly	『まっすぐに』,一直線に / 『直接に』,じかに / 『まさに』,全く(absolutely, exactly) / 『すぐに』,直ちに(at once)《英話》やがて,ほどなく / …するとすぐに(as soon as)
director	『指導者』,指揮者 / (会社・法人の)『重役』,取締役 / (映画・演劇・テレビ番組などの)『監督』,演出家,ディレクター / (オーケストラ・合唱団などの)指揮者(conductor) / (私立学校の)校長(principal)(施設の)所長,(役所の)局長,部長
directorate	管理職 / 《集合的に;《米》では複数扱い,《英》では単数・複数扱い》取締役会,重役会
directorship	管理者の職(任期)
directory	人名簿,住所録 / (ビルの)居住者表示板
direful	恐ろしい,悲惨な
dirge	哀歌(elegy),葬送歌
dirigible	気球(balloon),飛行船(airship)
dirk	(昔スコットランドで用いた)短剣
dirndl	ダーンドル(チロル農民ふうの婦人服で,ぴったりした胴着とゆったりしたスカートから成る) / ダーンドルふうのスカート
dirt	『不潔な物』,汚物;泥,ほこり,ごみ / 土(soil) / 無価値なもの / わい談,春画,わいせつ本(pornography) / 《話》卑わいな言葉;(特に)卑わいな悪口
dirt farmer	自作農
dirt road	舗装してない道路
dirt track	ダートトラック(土・石炭がらを敷いたオートバイ競走路)
dirt-cheap	ごく安い,二束三文の / ただ同然で,二束三文で
dirtily	不潔に,汚く / 下品に
dirty	『汚い』,汚れた,不潔な;泥だらけの,泥んこの / 『不正な』,卑劣な,下劣な / 『下品な』,卑わいな,わいせつな / 《話》(天気が)荒れ模様の(stormy) / (原子兵器が)汚れた,放射性降下物の多い,放射能の多い / …を『汚す』;〈名誉・名声など〉を汚す,傷つける / 汚れる
dirty work	いやな仕事,下働き,よごれ仕事 / 《話》ごまかし,ぺてん
disability	〈U〉障害 / 〈C〉身体的・精神的障害 / (法的)無能力
disable	《しばしば受動態で》…を役に立たなくする,無力にする,動けなくする / 《文》(…から)…を失格させる,無能力にする《+『名』+『from』+『名』(do『ing』)》
disabled	身体障害の不具の,無能力になった
disabuse	(…について)〈人〉の迷いを解く,誤解を解く《+『名』+『of』+『名』》
disadvantage	〈C〉『不利な立場』(状態) / 〈U〉『不利』,不利益;(名声・信用などの)損傷,損失
disadvantaged	恵まれない,不利な立場にいる
disadvantageous	不利な,都合の悪い;損な
disaffect	〈人〉に不満を抱かせる,をいやにさせる
disaffected	政治的に不満な,非友好的な;(…に対して)不満のある《+『to』(『toward』)+『名』》
disaffection	(政治上の)不平,不満;離反
disaffiliate	(…から)〈自分自身〉の関係を絶つ,縁を切る《+one『self from』+『名』》 / (…を)脱退する《+『from』+『名』》
