title role	主題役(主人公の名が題名となっている劇の主人公役,たとえば悲劇 Hamlet における Hamlet 役)
titled	(特に高貴な)肩書きのある,爵位のある
titleholder	選手権保持者(チーム)
titmouse	シジュウカラの類の小鳥
titter	〈女性が〉くすくす笑う,忍び笑いする / くすくす笑い,忍び笑い
tittle	《しばしば a tittle》《通例否定文で》(…の)ごくわずか《+of+名》 / (字の上の)小点,点画(iの点など)
tittle-tattle	うわさ話;(くだらない)おしゃべり / うわさ話をする;(くだらない)おしゃべりをする
titty	=tit
titular	名義上の,名ばかりの,有名無実の / 表題の,題の
tizzy	興奮;身震い
tk.	tank / truck
tkt	ticket
tn.	ton / town / train
tng.	training
tnpk.	turnpike
to	《方向》(1)(到着の意を含めて)…『へ』,に,まで / 《状況の変化》…[のほう]へ;…に[なるまで],その結果…になる / 《適用範囲》(1)《動詞に伴って》『…に対して』,に,へ / (2)《形容詞[句]・[代]名詞に伴って》『…に対して』 / 《程度・範囲》『…[に至る]まで』 / 《時間の終り》『…まで』(till) / 《to one's+『名』の形で》(…が)『…したことに[は]』 / 《比較・対比・割合》『…と比べて』,より,に対して / 《一致・適合》『…に合わせて』,に合って,に応じて / 《目的・意図》『…のために』 / 《運命・境遇》『…に』 / 《所属・関係》『…へ』,に[対して] / 《付加・付着・固執》『…に』 / 《対立・対向》…に[対して] / いつもの状態(位置)に / 停止(閉鎖)の状態に / 活動状態に(へ),仕事に / 《名詞的用法》『…すること』 / 《形容詞的用法》『…するための,すべき』 / 《副詞的用法》『…するために』,して,するとは,すれば / 《独立用法》 / 《文全体を修飾する慣用語句》…すれば,してみると,…だが / 短縮文
to and fro	あち(ら)こち(ら)に, 行ったり来たり
to-and-fro	(比較変化なし)あちこちに動く,前後[左右]に動く / =to and fro / (…の)往復運動,前後運動,交互に反対方向に向かう運動(流れ)《+of+名》
to-do list	やらなければならないことのリスト、やることリスト
toad	ヒキガエル,大形のカエル
toad-in-the-hole	衣をつけて揚げたソーセージ トードインザホール 衣のついたソーセージをオーブンで焼いた料理
toadstool	(特に)毒きのこ
toady	おべっか使い,追従者 / (…に)おべっかを通う《+to+名》
toast	トースト / 〈パン・チーズなど〉をきつね色に焦がす / …をよく暖める / きつね色に焼ける / よく暖まる / (…のために)祝杯を上げること,乾杯すること《+to+名》 / 乾杯を受ける人(物,行事など) / …を祝って乾杯する / 乾杯をする
toaster	トースター
toasting fork	(パンを焼くための)柄の長いフォーク
toastmaster	乾杯の辞を述べる人,宴会の司会者
tobacco	〈C〉『タバコの木』 / 〈U〉〈C〉『タバコの葉』 / 〈C〉(加工して製品にした)『たばこ』(紙巻きたばこ(cigarettes),葉巻(cigars),かきたばこ(snuff)など) / 〈U〉喫煙(smoking)
tobacconist	たばこ業者,たばこ屋の主人(店員)
toboggan	トボガン,リュージュ(1枚の板の一方の先端を丸く曲げて作ったそりで雪の斜面を滑る遊戯・競技用のもの) / トボガンに乗る(で滑り降りる)
toby jug	三角帽子をかぶった太った老人を型どったビールジョッキ
toccata	トッカータ(演奏者の技巧を見せるように意図された鍵盤楽器のための自由な形式の曲)
tocsin	ベルによる合図;(特に)ベルによる警報,警鐘
today	『きょう[は]』,本日[は] / 『現代では』,今日では / 『きょう』,本日 / 『現代』,今日
toddle	〈幼児などが〉よちよち歩く
toddler	よちよち歩きをしはじめた幼児
toddy	トデー(ウイスキーなどを湯で割って砂糖やレモンを加えた飲み物) / (ある種のヤシの木の)樹液;(それを発酵させた)シュロ酒
todo	(…についての)大騒ぎ,騒動 = to-do 《+about(over)+名(doing)》
toe	『足の指』 / (靴・靴下などの)『つま先』 / (動物の)足指に相当する部分;ひづめの前部 / (形・位置・機能が)足指に似たもの / 〈靴・靴下など〉につま先を付ける / 〈くぎなど〉を斜めに打ち込む / (斜めに打ち込んだくぎで)…を締める,留める / つま先をある方向に向ける
toecap	(靴の)つま革,飾り革
toed	足指のある / 《複合語を作って》足指が…の:five-toed 足指が5本の
toehold	(岩場などでの)足場,足掛かり
toenail	足指のつめ / 斜めに打ち込んだくぎ
toff	上流階級のしゃれ者
toffee, toffy	=taffy
toffee-nosed	気どった
tog	着物,衣服 / (…を)〈自分〉に着せる《+oneself up(out) in+名》
toga	トーガ(古代ローマ市民の着たゆるやかな外衣)
together	『いっしょに』,共に,連れ立って / 『一団(一体)となるように』 / 『互いに』(…し合う) / 『協力して』,一致して,調和して / ひっくるめて,総合して / 同時に,一度に
togetherness	一体感,まとまり,団結 / 親善,親睦
toggle	(縄の端の輪や鎖の輪などに通す)留め金,留め棒 / (洋服のボタン代りに使う)細長い棒状の飾りボタン
toggle switch	トグルスイッチ(つまみを上下あるいは左右に動かせる電源スイッチ)
toil	『骨折って(精を出して)働く』,(…を)精を出してする《+at+名(doing)》 / 骨折って進む《+along(on,over,through,up)+名》 / 『骨折り仕事』,苦労(類語) / 仕掛けた網,わな
toile troll	巻きトイレットペーパー
toiler	働き者;労働者
toilet	〈C〉(水洗式の)『便器』 / 〈C〉(水洗式便器のある)洗面所,化粧室,浴室;トイレ,便所(アメリカでは「restroom」とか「bathroom」と言い換えた呼び方が普通)〈U〉〈C〉化粧,身じたく / 〈U〉〈C〉《文》服装,衣装
toilet paper	トイレットペーパー
toilet soap	化粧品けん
toilet water	化粧水,オーデコロン
toilet-train	〈幼児〉に排便排尿のしつけをする
toiletry	化粧品(オーデコロン・石けんなど)
toilette	=toilet
toing and froing	行ったり来たりすること,堂々巡り,むだな努力
toke	マリファナたばこの一服 / 〈マリファナたばこ〉を吸う,に火をつける
token	(…の)『しるし』,象徴《+of+名》 / (…の)『記念品』,形見《+of+名》 / (また token coin)代用硬貨(バスや地下鉄などで切符の代りに用いられるもの) / 名(形)ばかりの,ほんのわずかの
token nigger	白人の会社、政権、その他の組織において、いかにも「自分たちは進歩的で人種差別とは無縁である」ということを強調するために象徴的に雇用する黒人、またはその立場の黒人
tokenism	(特に人種差別廃止における)名目主義
told	tell の過去・過去分詞
tolerable	がまんできる,耐えられる / 相当の;まあまあの
tolerably	がまんできるほどに;かなり;まあまあ
tolerance	(自分と異なる他人の意見・行動などを許す)寛大,寛容・我慢(がまん),忍耐力 / (薬品・毒物などに対する)耐性,抗毒性 / 公差,許容誤差
tolerant	寛大な,寛容な;(…に)寛大な《+of(to)+名》 / (薬品・毒物などの作用に)耐性がある,抵抗力のある
tolerantly	寛大に
tolerate	…に『寛大な態度をとる』,を黙認する / …を『がまんする』,耐える / 〈薬品・毒物など〉に耐性がある
toleration	寛容,黙認;がまん / 宗教の自由を認めること,宗教的寛容
toll	〈鐘が〉(にっくり規則的に繰り返して)鳴る / (ゆっくり規則的に繰り返して)〈鐘〉を鳴らす / 〈鐘が〉…を知らせる / 鐘を鳴らすこと / 鐘の音 / (橋・道路などの)『使用[通行]料金』,使用税 / (長距離電話などの)『料金』,サービス料 / 《通例単数形で》(災難などの)被害の程度,犠牲(死傷)負数
toll road	有料道路
tollbooth	有料道路料金徴収所
tollgate	通行料金徴収所
tollhouse	通行料金徴収事務所
toluene	トルエン(芳香族化合物;染料・火薬・医薬品の原料)
tom	(動物の)雄;(特に)雄猫
tom-tom	(アメリカインディアンなどが手でたたく)太鼓,タムタム
tomahawk	(北米インディアンの)戦闘用おの,トマホーク / …を戦闘用おので攻撃する(殺す)
tomato	『トマト』;トマトの木
tomb	『墓』(grave);(一般に)埋葬場所
tombola	《おもに英》富くじ式のゲーム
tomboy	おてんば娘
tombstone	墓石,墓碑
tomcat	雄猫
tome	大冊,大著
tomfoolery	ばかな行為,ばかなまね
tommyrot	たわごと,ばかげたこと
tomorrow	『明日[に]』,あした / 『明日』,あした / 将来
tomtit	シジュウカラ・ミソサザイなどの小鳥
ton	(重量単位の)『トン』 / (容積単位の)トン(物によって異なり,木材では40立方フィート,小麦では20立方フィート) / 《話》大量(の…),多数(の…)《+of+名》
ton-up	スピード狂の,暴走族の
tonal	音の;色調の
tonality	(音楽で)調性;(美術で)色調
tone	〈C〉(高さ・音色・長さ・音量の点から見た)『音』 / 〈C〉〈U〉音質 / 〈C〉楽音;全音程 / 〈C〉《しばしば複数形で》『言い方,書き方』,口調,語調 / 〈C〉支配的な(一般的な)風潮(傾向) / 〈U〉(筋肉などの緊張の)『正常な状態』 / 〈C〉『色調』,色合い,濃淡,明暗 / (音・色などで)…に『ある調子(口調,色合い)をつける』 / …の色を変える,色を補正する
