trump	〈C〉(カードの)切り札:play a(one's) trump 切り札を出す / 《複数形で》切り札の組 / 〈C〉《話》りっぱな人,頼りになる人 / 〈札〉を切り札で取る / 切り札を出す / らっぱ[の音]
trump card	切り札,奥の手
trumpery	見かけ倒しのもの / 無意味な言葉(計画・行動など) / 見かけ倒しの,安っぽい / 無意味な,価値のない
trumpet	『トランペット』,らっぱ / らっぱのような形をした物;(レコードプレーヤー・ラジオなどの)拡声器;補聴器 / 象の大きな鳴き声 / らっぱを吹く / 〈象が〉らっぱにような鳴き声を出す / …をらっぱで知らせる / …を吹聴する
trumpeter	トランペット奏者; トランペットの演奏者 / (北米産の)野生ハクチョウの一種
truncate	〈円錐・樹木など〉の頭(端)を切る / 〈文章など〉を切って詰める / 切り取られた / (生物の形態が)切形の(先端を切り取ったような形をしていること)
truncheon	《おもに英》(巡査などの)こん棒,警棒・(職権の象徴としての) 職[官]杖(じょう) (mace)・…をこん棒で打つ
trundle	〈輪・手押し車など〉をころがす,ごろごろ動かす / 〈輪・手押し車などが〉ころがる,ごろごろ動く / 小型の車輪 / =trundle bed
trundle bed	(応急補充用)脚輪つき寝台(使用しないときは他のベッドの下に入れる;《英》truckle bed)
trunk	(枝および根と区別して樹木の)『幹』 / (人・動物の)胴体 / 『トランク』(旅行用箱型の大型かばん) / 象の鼻 / 《複数形で》(水泳などスポーツ競技用の)男子用パンツ,トランクス / 《米》(自動車後部の)荷物入れ,トランク(《英》boot) / =trunk line
trunk call	=long distance 1
trunk line	(鉄道・道路の)幹線・本線 / (2主要局間の)電話中継回線
trunk road	幹線道路
truss	トラス,けた構え(屋根・橋などを支える一種のはり材) / 脱腸帯 / 《英》(干し草・わらなどの)束 / (ひも・ロープなどで)…を縛る,束ねる《+up+名+,+名+up》 / (料理前に)〈鳥〉の翼や足を胴に縛りつける《+up+名,+名+up》 / 〈屋根・橋など〉をけた構えで支える
trust	〈U〉(人の誠実さ・能力,物の性能などに対する)信頼,信任,信用《+in+名》 / 〈C〉信頼できる人(物) / 〈U〉『期待』,確信,希望 / 〈U〉委託,保管,管理;世話,保護 / 〈U〉(信頼にこたえる)義務,責任;(託された)責務 / 〈C〉(財産の)信託;〈U〉信託財産 / 〈C〉(市場を独占しようとする目的で結成された)企業合同,トラスト / 〈人・物事〉を『信用する』,信頼する / …を当てにする,に頼る(depend on) / 《trust+that節》…と『期待する』,確信する / 《trust+名+to+名》(人に)…を『任せる』,委託する,信託する / 《trust+名+for+名》(…を)〈人〉に信用貸しする,掛け売りする / (…を)信用する,信頼する《+in+名》 / (…を)当てにする《+to+名(doing)》 / 期待する,確信する(hope)
trust fund	信託資金
trust territory	(国連の)信託統治地域
trustee	(他人の財産の)受託者,保管人 / (学校などの)評議員,理事
trusteeship	〈C〉〈U〉受託者(評議員,理事)の地位 / 〈U〉(国連の)信託統治 / =trust territory
trustful	信じやすい,人をすぐ信用する
trusting	信頼する,信用する
trustworthiness	信頼に値すること,頼もしさ
trustworthy	(人・言明など)信頼に値する,信頼できる
trusty	(人が)信頼できる,頼りになる / 信頼できる人 / (特典の与えられる)模範囚
truth	〈U〉(物事の)真実,事実,真相 / 〈U〉『真実性』,真実味,ほんとうのこと / 〈C〉『真理』,原理 / 〈U〉誠実さ,実直さ,正直
truth serum	自白薬(心理抑制を解除させる薬;犯罪調査などに使う)
truthful	(人が)真実をいう,誠実な / (記述・説明などが)真実の,正確な(accurate)
try	…に『努力する』,を努める / …を『試す』,してみる,使って(食べて,飲んで)みる / 〈戸・窓など〉を開けようとする / 〈人〉を『裁く』;〈事件〉を『裁判する』 / 〈人〉をつらい目に会わせる,悩ます / …を酷使する,疲れさせる / 『試みる』,やってみる,努力する / 試し,試み;努力 / (ラグビーの)トライ
try square	(大工などの用いる)曲尺,直角定規
trying	try の現在分詞 / 『つらい』,苦しい;腹だたしい,しゃくにさわる
tryout	(選手・俳優などの)適性審査;オーディション
tryst	(特に恋人同士の)密会の約束 / 約束した密会,あいびきの場所
tsar	=czar
tsarina	=czarina
tsetse fly	ツェツェバエ(吸血性で眠り病を媒介する南アフリカ産のイエバエの一種)
tsp	teaspoon / teaspoonful
tu-whit tu-whoo	ホーホー(フクロウの鳴声)
tub	『おけ』,たらい / 《話》bath 2 / (また tubful)おけ1杯[の量](の…)《+of+名》 / 《話》のろくてぶかっこうな船;《俗》でぶ,太っちょ
tub thumper	熱弁家
tuba	チューバ(低音の大型金管楽器)
tubby	(人が)背が低くて太った,ずんぐりした
tube	(金属・ガラス・ゴムなどの)管,筒 / (絵の具・歯みがきなどの)チューブ / 《米》(列車・地下鉄の)トンネル / 《英》地下鉄(《米》subway) / (ラジオ・テレビなどの)真空管(vacuum tube) / (動植物の)管状器官
tubeless	チューブ無しの
tuber	塊茎(ジャガイモのような塊状の地下室茎)
tubercle	小塊茎,塊根 / 瘤状突起,結節
tubercle bacillus	結核菌
tubercular	結節のある,結節状の / (また tuberculous)結核の,結核性の
tuberculate	結節を形成する(生物学的用語)
tuberculin	ツベルクリン注射液(結核感染の有無を調べるための注射液)
tuberculosis	結核(《略》TB,T.B.) / 肺結核
tuberculous	結核(性)の・ゲッカコウ(月下香)(ヒガンバナ科の球根植物)
tuberous	こぶのある,結節だらけの / 塊茎[状]の
tubful	桶一杯・ひとおけ
tubing	〈U〉管状の物 / 《集合的に》管類 / 〈C〉(ある長さの1本の)管
tubular	管状の,管から成る
tubule	小管,細管
tuck	《状態・方向を表す副詞[句]を伴って》(保護・安全などのために)…を『押し込む』,つめ込む / 《状態・方向を表す副詞[句]を伴って》…[の端(すそ)]を『差し込む』,折り込む / 〈衣服など〉に縫いひだ(タック)をつける / 〈C〉(そで・すそなどの)縫いひだ,タック,上げ / 〈U〉《英》(学童などが食べる)食物,(特に)菓子類 / 〈U〉《米》元気,精力
tuck shop	(特に)学校内の菓子店
tuck-in	すばらしいごちそう
tucker	〈人〉を疲れさせる《+out+名,+名+out》 / 〈C〉ひだを取る人(物) / 〈U〉タッカー(昔の婦人用の麻・モスリンなどで作った首・肩おおい)
tucker bag	[携帯]食料袋
tufa	トゥファ(温泉などに沈殿した炭酸石灰から成る多孔質の石灰石)
tuff	凝灰(ぎょうかい)岩
tuft	(羽毛・髪などの)ふさ《+of+名》 / (…の)やぶ,木立ち,茂み《+of+名》 / …をふさで飾る,にふさをつける
tufted	ふさのついた;ふさふさした
tug	(…を)『ぐいと引く』,強く引っ張る / 《副詞[句]を伴って》…を引きずって行く / 〈船〉を引き船で引く / (…を)『ぐいと引く』,ぐっと引っ張る《+at+名》 / ぐいと引くこと / =tugboat
tug of war	綱引き / 激しい争い = tug-of-war
tugboat	タグボート,引き船(大型の船を引く強力なエンジンを備えた小型船)
tuition	(大学・私立学校などの)授業料 / 授業,教授
tulip	『チューリップ』 / その花;その球根
tulip tree	(北米産の)ユリノキ,ハンテンボク(チューリップに似た花の咲く大木)
tulle	チュール(ベールなどに用いる網状の絹またはナイロンの薄い布)
tumble	《状態・方向を表す副詞[句]を伴って》『ころがる』,倒れる / ころげ回る,のたうち回る《+about》 / 《状態・方向を表す副詞[句]を伴って》ころがるようにして行く(来る) / くずれ落ちる,崩壊する《+down》 / (体操)とんぼ返りを打つ,くるくる回転する / 〈価格が〉急落する / 《状態・方向を表す副詞[句]を伴って》…をほうり投げる / …をめちゃくちゃにする / 〈C〉転倒,転落 / 〈U〉《しばしば A ~》混乱,乱雑,ごちゃごちゃ / 〈C〉とんぼ返り
tumbledown	(建物など)今にも倒れそうな,荒廃した
tumbler	軽業師 / タンブラー(平底で取っ手のないコップ) / (錠の)てこ
tumbleweed	秋になると風に吹き飛ばされる雑草(北米砂漠地帯のヒユ・アカザなど)
tumbling	宙返り,空中回転
tumbrel, tumbril	肥料運搬車 / (フランス革命時代の)死刑囚護送車
tumescent	腫れた
tumid	(体の一部などが)ふくれあがった / (言語などが)大げさな,誇張した
tumidity	はれ上がっていること / (言葉などの)誇張
tummy	《話》おなか,ぽんぽん,腹部
tumor, tumour	はれもの,できもの,腫瘍
tumult	騒ぎ,大騒ぎ;騒動,暴動 / (心の)動揺,興奮
tumultuous	(群衆などが)騒然とした / (心が)取り乱した
tumulus	(有史以前の)墳墓,古墳
tun	(特にワイン・ビールなどの)大だる / タン(液体,特にワイン・ビールなどの容量単位;通例252ガロン)
tuna	〈C〉(また tunny)マグロ / (また tunny, tuna fish)マグロの肉 / サボテンの一種
tundra	(シベリアなどの)凍土帯,ツンドラ
tune	(音楽の)『曲』,節(ふし),メロディー(melody) / 〈楽器〉の調子を合わせる,を調律する《+up+名,+名+up》 / 〈エンジンなど〉を調整する《+up+名,+名+up》 / (…に)〈受信機〉を同調させる,の波長を合わせる《+名+to+名》
tune-up	(エンジンなどの)調整
tuneful	旋律の美しい,調子のよい,音楽的な
tuneless	調子はずれの,音楽的でない / (楽器が)音の出ない
tuner	(ピアノなどの)調律師 / (ラジオ・テレビの)チューナー,同調器
tung oil	桐油(ワニスやリノリウムの原料)
tungsten	タングステン(金属元素;化学記号は W)
tunic	チュニカ(古代ギリシア・ローマで男女が用いたひざまである半そでまたはそでなしの上着) / (ゆったりしたそでなしの)チューニック(婦人用スポーツ服,女子学生の制服などに用いる) / 《英》軍人・警官などが制服として着る一種の上着
tuning fork	音叉(楽器調律に使うフォーク状の鋼鉄製の器具)
tunnel	『トンネル』,地下道,坑道 / 〈山など〉にトンネルを掘る / 〈トンネルなど〉を掘る / トンネルを掘る
tunnel vision	視野狭窄(症) トンネルビジョン きわめて狭い視野 偏狭
