fever	〈U〉《しばしばa fever》(身体の異常な)『熱』,発熱 / 〈U〉『熱病』 / 〈U〉〈C〉(…に対する)『興奮』,熱狂《+『for』+『名』》
fever blister	=cold sore
fever heat	(37℃以上ある)病的な体温,病熱 / 熱狂
fever pitch	興奮の高まり,熱狂
fevered	(比較変化なし)《名詞の前にのみ用いて》熱のある,熱病にかかった / 熱にうかされたような,興奮した / (憎しみなどが)異常に強い
feverish	熱っぽい / 発熱による,熱病の / 熱病の起こりやすい(流行している) / 興奮した,熱狂的な
few	《aをつけて肯定的に》『少しはある』,多少の,いくつかの / 《aをつけないで否定的に》『ほとんどない』,少数(少し)しかない / 《aをつけて肯定的に》(…の)『少数の人』(『物』)《+『of』+『名』〈複数〉》 / 《aをつけないで否定的に》(…の)少数の人(物)[しかない]《+『of』+『名』〈複数形〉》 / 《the~》少数の人たち,選ばれた人たち
fey	《軽べつして》(人やふるまいが)気のきかない,役立たずの / 《おもにスコットランド》呪文にかかったような,のろわれた / 超自然的な / 死の迫った
fez	トルコ帽(頂上に黒ふさのついた赤色のフェルト帽)
ff	fortissimo
ff.	and the following [pages,verses,etc.] / folios
fiance	(女性からみた)婚約者,いいなずけの男
fiancee	(男性からみた)婚約者,いいなずけの女
fiasco	(企画などの)大失敗
fiat	(権力者の)命令,布告;(…という)命令《+『that節』》
fiat money	法定不換紙幣
fib	(ささいな,罪のない)うそ / 軽いうそをつく
fiber optics	繊維光学(ガラス・プラスチックなどの細長い繊維で光や像を伝達する技術) / 繊維光学に使う繊維
fiber, fibre	(1本の)『繊維』,すじ / 〈U〉《集合的に》繊維,繊維組織 / 〈U〉(布の)生地,織り地(textile) / 〈U〉性格,性質;根性
fiberboard,fibreboard	(建築用の)繊維板
fiberfill	化繊綿(枕などの詰め物に使うポリエステルなどの合成繊維)
fiberglass,fibreglass	繊維ガラス[商標名Fiberglasから]
fibre	=fiber
fibril	微小繊維 / (植物の)根毛 / (生物体の組織の)原線維
fibrin	(凝固血液中の)線維素,フィブリン
fibroid	(腫瘍などが)線維から成る,線維状の
fibrosis	線維症(線維性結合線維が増殖し過ぎる症状)
fibrositis	リューマチ性の筋肉障害
fibrous	繊維の,繊維状(質)の
fibula	(下腿部の)腓骨(ひこつ)
fiche	=microfiche
fichu	婦人用三角ストール
fickle	変わりやすい,気まぐれな,あてにならない
fiction	〈C〉〈U〉『作り話』,作り事,虚構 / 〈U〉(文学様式の)『小説』,創作
fictional	作り事の,架空の;小説の
fictionalization,fictionalisation	物語化
fictionalize,fictionalise	〈実際のでき事〉を物語化する
fictitious	架空の,創作の,偽りの
fictive	創作力のある / 《まれ》=fictitious
fiddle	《話》バイオリン(violin) / 《俗》詐欺行為・ぺてん / バイオリンをひく / (物を)いじくる,もてあそぶ《+『with』+『名』》 / のらくらして暇をつぶす《+『around』(『about』)》 / 〈曲など〉をバイオリンでひく / 〈時間〉をむだに過ごす《+『away』+『名』,+『名』+『away』》 / 〈税金・数字など〉をごまかす
fiddle-faddle	くだらない事,つまらない事,ささいな事
fiddler	《話》バイオリンひき(violinist) / 《俗》詐欺師,ぺてん師
fiddler crab	シオマネキ(スナガニの一種で雄は左右いずれかのハサミが大きい)
fiddlestick	〈C〉バイオリンの弓(本来の意味) / 《話》《古風》《軽蔑》くだらないもの,ばかばかしいもの
fiddlesticks	くだらない,ばかばかしい
fiddling	くだらない,ささいな
fidelity	(…に対する)忠実,誠実,忠節,貞節《+『to』+『名』》 / (事実に対しての)正確さ,厳密さ / (ラジオの音などの)忠実度
fidget	そわそわする,もぞもぞする / (物を)いじる,もてあそぶ《+『with』+『名』》 / 〈人〉に気をもたせる / 《the fidgets》そわそわすること,落ち着かないこと / 〈C〉落ち着かない人
fidgety	そわそわする,落ち着かない(restless)
fiduciary	他人の財産を委託された人,受託者,被信託者 / 信用上の,信託に基づいた
fie	(軽べつ・非難を表して)ええっ,まあ
fief,feoff	封土,領土(feud)
field	〈C〉『野原』,[牧]草地;田;畑;《the fields》田野,田畑 / 〈C〉(雪・氷などの)原,広がり / 〈C〉(鉱物などの)産出地,埋蔵地 / 〈C〉『戦場』(battlefield);戦闘(battle) / 〈C〉(スポーツの)『競技場』;(陸上のトラックに対して)フィールド / 〈C〉(ある用途の)場,地面 / 〈C〉(研究・活動などの)『分野』,領域 / 《the~》現地 / 〈C〉(電気・磁気などの)場;(レンズの)視界 / 〈C〉(絵・旗などの)地,下地 / 《the~》《集合的に》(キツネ狩り・競技の)参加者;(競馬の)出走馬;(野球の)守備選手 / (野球・クリケットで)〈打球〉をさばく / 〈選手〉を出場させる,守備につける / (野球・クリケットで)野手をつとめる
field day	軍隊の野外演習日 / 《話》大いに楽しめる日 / 《特に米》運動会の日
field event	フィールド競技(円盤投げ・やり投げ・ジャンプ競技など)
field glasses	(野外携帯用の)双眼鏡
field goal	(米式フットボールで)プレースキックであげたゴール(3点) / (バスケットボールで)フィールドからのゴール(2点)
field gun	野砲(野戦に用いられる車輪のついた軽い大砲)
field hand	農業労働者,作男
field hockey	陸上ホッケー
field hospital	野戦病院
field marshal	(英国の)陸軍元師
field mouse	野ネズミ
field of vision	視界,視域
field officer	佐官(陸軍の大佐・中佐・少佐級の将校)
field-test	〈新製品など〉を工場や研究室の外で実際に使ってみる,実地試験する
fielder	(野球・クリケットなどの)野手(フィールドで守備をしている選手)
fieldpiece	野砲
fieldstone	(未加工の建築用)自然石
fieldtrip	(博物館・工場・農園などの)見学旅行,実地研究旅行
fieldwork	〈U〉(科学・社会学などの)野外研究,実地調査 / 〈C〉(戦場での)速成の簡易とりで
fiend	悪魔(devil),悪鬼 / 邪悪(残忍)な人 / 《話》(趣味などに)凝っている人;麻薬などの常習者
fiendish	悪魔のような,残忍な / 《話》(行動が)賢い / 《話》かなりの,ひどい
fierce	(性質・行動など)『凶暴な』,どう猛な / (強さ・程度などの)『激しい』,猛烈な
fiercely	凶暴に;猛烈に
fierceness	凶暴さ;猛烈さ
fierily	火のように,熱烈に
fieriness	火のようなこと,熱烈さ
fiery	『火の』,火のついた,燃えている / (火のように)『ひどく熱い』,『真赤な』,輝く / 『熱烈な』,激しい / (気性などが)激しやすい,荒々しい
fiesta	(スペイン系諸国の)聖人の祝日 / (一般に)祝祭;休日
fife	(軍楽隊用の)横笛 / 〈曲〉を横笛で吹く / 横笛を吹く
fifteen	〈C〉(数の)『15』;15記号(15,XVなど) / 〈U〉(24時間制の)15時,15分;15歳 / 〈U〉《複数扱い》15人,15個 / 〈C〉15(15人,15個)一組のもの;ラグビーチームのメンバー / 『15』の,15個の,15人の / 《補語にのみ用いて》15歳の(で)
fifteenth	『第15の』,15番目の / 15分の1の / 《the~》『第15』,15番目[のもの];(月の)15日
fifth	《the~》『第5の』,5番目の / 5分の1の / 《the~》『第5』,5番目[のもの];(月の)5日 / 〈C〉5分の1 / 〈C〉《米》5分の1ガロン[びん]
fifth column	第五列(国内のスパイ活動,破壊行為で敵国を助ける集団)
fifth wheel	転向輪(馬車の転向を容易にするために前車輪に平行して付いている車輪) / 余りもの,無用の長物
fiftieth	『第50の』,50番目の / 50分の1の / 《the~》『第50』,50番目[のもの] / 〈C〉50分の1
fifty	〈C〉(数の)『50』;50記号(50,Lなど) / 〈U〉50分;50歳 / 〈U〉《複数扱い》50人,50個 / 《the fifties》(世紀の)50年代;(年齢の)50代 / 『50の』,50個の,50人の / 《補語にのみ用いて》50歳の(で)
fifty-fifty	半々の,五分五分の / 半々に
fig	いちじくの木(実) / 《a~》《話》《通例否定文に用いて》取るに足らないもの
fig leaf	いちじくの葉 / いちじくの葉形のおおい(絵画・彫刻で局部を隠すのに使われている)
fig tree	いちじくの木
fig.	figure:fig.5(本の中に用いて)第5図
fight	〈両者・数人が〉『戦う』,格闘する,殴り合い(取っ組み合い)のけんかをする;激しく口論する / …と『戦う』 / 〈戦い〉を交える,〈決闘など〉を戦う / …を制圧(克服)しようとする / 〈犬など〉を戦わせる / 〈軍艦・軍隊など〉を指揮する,操縦する / 〈C〉(…との)『戦い』,戦闘;格闘《+『against』(『with』)+『名』》 / 〈C〉(…との)奮闘,闘争(struggle)《+『for』(『with』,『against』)+『名』》 / (また『fighting spirit』)〈U〉『闘志』,ファイト / 〈C〉(…についての)論争,口論《+『over』+『名』》 / 〈C〉(特にボクシングの)試合,勝負
fighter	戦う人,戦士,闘士 / プロボクサー / (またfighter plane)戦闘機
fighter pilot	戦闘機の操縦士
fighting	戦闘;好戦的な(warlike) 戦い, 戦闘; (形容詞的) 戦闘(用)の
fighting chance	努力すれば成功するかも知れない(…する)見込み《+『to』 do》
figment	作りごと
figuration	形作ること,形成 / 形態,形状 / 装飾
