rainbow trout	ニジマス
raincoat	レインコート
raindrop	雨だれ
rainfall	〈C〉降雨,雨降り / 〈U〉雨量
rainforest	熱帯雨林 / 雨林、降雨林、多雨林
rainmaker	(アメリカインディアンの)雨ごい師 / 人工降雨技師
rainmaking	人工降雨法
rainproof	防水の
rainstorm	暴風雨
rainwater	雨水,天水
rainy	『雨の』,雨降りの;雨の多い / 雨にぬれた;雨模様の
raise	…を『上げる』,持ち上げる;〈倒れた物〉を起こす / …の量(程度,価値など)『を上げる』 / 〈地位,名声〉を『高める』;(…の地位などに)…を上げる,高くする《+『名』+『to』+『名』》 / …を生じさせる / …を集める,調達する / 《米》…を育てる,栽培する,飼う / 《おもに米》〈子供・家族〉を扶養する,養育する / 〈建物・像など〉を建てる / 〈気持ち・人など〉を奮い立たせる / 〈疑問・異議・要求など〉を提起する,持ち出す / 〈禁止・封鎖など〉を解く / 〈死者〉を生き返らせる / 〈パン〉をふくらませる / 『賃上げ』,『昇給』;昇給額(《英》rise)
raisin	干しぶどう
raison d'être	存在理由
raj	(インド・パキスタンで)支配[期間];(特にインドでの)英国統治
rajah, raja	(インドの)王;(東南アジアの)首長(しゅちょう)
rake	熊手(くまで),草かき;くまでの形の道具(賭博(とばく)場で金を集めるのに使うものなど) / …をくまででかき集める;〈場所〉をくまででかきならす《+『together(up)』+『名,』+『名』+『together(up)』》 / (…を求めて)〈場所〉をくまなく捜す《+『名』+『for』+『名』》 / …を機銃掃射する / くまでで集める(かきならす) / (…を求めて)かきわけて捜す《+『for』+『名』》・「rake it in」で《口語》 金をうんともうける[稼ぐ] / 放蕩(ほうとう)者,道楽者 / (マストなどの)傾斜,勾配(こうばい) / 〈マスト・煙突など〉を傾斜させる / 〈マスト・煙突などが〉傾斜する
rake-off	(不正な仕事の)分け前,割り前;リベート
rakish	放蕩(ほうとう)な,不品行な,みだらな / いきな / (船が)軽快な,速力のありそうな
rallentando	次第にゆるやかになる楽節(旋律) / 次第にゆるやかな / 次第にゆるやかに
rallier	(共通の目的のために)人を呼び集める人 / 元気づける人
rally	(…のもとに)〈人〉を『再び集める』《+『名』〈人〉+『around』(『to, behind』)+『名』》 / (…に対して)〈気力・体力など〉を『持ち直す』,もう一度奮い起こす《+『名』+『for』(『to』)+『名』》 / (…のもとに)『再び集まる』;(援助などのために)はせ参じる《+『around』(『to, behind』)+『名』》 / (不幸・病気などから)『持ち直す』,立ち直る《+『from』+『名』》 / (テニスなどで)続けて打ち合う / (次の活動のための)再結集 / (悪い状態からの)『持ち直し』,回復《+『from』+『名』》 / (特定の目的のための)集会,大会 / (テニスの)ラリー(続けて打ち合うこと) / ラリー(長距離自動車レース) / (悪意がなくて)…をからかう,ひやかす
ram	(去勢しない)雄羊 / 破城づち(先に鉄のつめのついたさおで,戸・城壁などを破るのに用いた) / くい打ち機 / (…に)…を激しく打ちつける(打ち込む)《+『名』+『against』(『into』)+『名』》 / …に激突する / (…に)…を詰め込む,押し込む《+『名』+『into』(『in』, 『down』)+『名』》 / (…に)激突する《+『against』(『into』)+『名』》
ramble	《副詞[句]を伴って》あてもなく歩く,ぶらつく / 〈植物が〉はびこる / ぶらぶら歩き,散歩
rambler	ぶらぶら歩く人;とりとめなくしゃべる(書く)人 / つるバラ
rambling	ぶらぶら歩く,さまよう / (建物・道路などが)不規則に広がった;曲がりくねった / (話・記述・気持ちなどが)とりとめのない,決まらない,ふらついた
rambunctious	《おどけて》乱暴な,手に負えない
ramekin	ラミキン(チーズやパン・卵などを混ぜて1人前ずつ焼いた料理) / ラミキン料理用の皿
ramie	〈C〉カラムシ(アジア産の低木で織物用の繊維が採れる) / 〈U〉カラムシの繊維
ramification	枝に分かれること,分岐 / 結果,成り行き
ramify	…を枝のように分ける;…を網の目のように広げる / 枝のように分かれる;網の目のように広がる
ramjet	ラムジェット(航空機のジェットエンジンの一種)
ramp	詐欺,かたり / (病院・ガレージ・立体高速道路の出入口などの)傾斜通路,ランプ / (飛行機の)タラップ
rampage	狂暴な行動,大暴れ / 暴れる,怒り狂う
rampageous	大暴れの,始末に負えない
rampager	暴れん坊
rampant	(雑草などが)はびこった / (病気などが)流行した / 《名詞の後に置いて》(紋章のライオンなどが)後ろ脚で立ち上がって前脚を振り上げた
rampart	(通例,土の)城壁,塁壁 / (一般に)防御物
ramrod	(昔の前装銃(砲)に火薬を詰め込む)込め矢・洗い矢(銃身をそうじするための鉄の棒)
ramshackle	(家屋などが)倒れそうな,がたがたの
ran	runの過去形
ranch	(米国西部・カナダの)大牧場 / 《米》農場,飼育場 / 牧場を経営する;牧場で働く
ranch house	牧場主の家 / 《米》平屋(屋根の勾配のゆるい家)
rancher	牧場経営者;牧場労働者;カウボーイ
ranchman	=rancher
rancid	(バター・油・油でいためた食物などが)悪臭のある,くさったにおいがする
rancidity	いやなにおい(味)のすること / いやなにおい,悪臭;いやな味
rancor,rancour	(人に対する)深い恨み,強い憎しみ《+『against』+『名』》
rancorous	深く憎んでいる,恨みをいだいた
rand	ランド(南アフリカ共和国の通貨の単位)
random	『手当たりしだいの』,任意の;行き当たりばったりの
random access	ランダムアクセス(コンピューターの記憶装置でデータの位置に関係なく同じ時間でデータを取り出せる方式) 任意抽出(ランダムアクセス方式) データを任意の順序で抽出利用できる方式
random sample	任意抽出例
random sampling	(統計で)任意(無作為)抽出法
randomization,randomisation	成り行きまかせ[ですること]
randomize,randomise	…を成り行き任せでする / 成り行きでする
randy	みだらな,好色な
ranee	(インドで)王妃 / (統治者としての)女王
rang	ringの過去
range	〈U〉《時にa~》(価格・気温などの変動の)『幅』 / 〈U〉《時にa~》(知覚・知識などの)『範囲』,広がり / 〈U〉《時にa~》(銃砲・ミサイルなどの)着弾距離,射程 / 〈U〉《時a~》(航空機・船舶などの)航続距離 / 〈C〉(銃砲の)射撃場,(ミサイルなどの)試射場 / 〈C〉《米》放牧地域 / 〈C〉(山などの)列,連なり / 〈C〉(料理用の)レンジ / 〈U〉《しばしばa~》(動植物の)生息(分布)区域 / 《副詞句を伴って》(価格・気温などがある範囲内で)『変動する』,動く / (…を)さまよう,歩き回る,(…に)及ぶ《+『over』(『through』)+『名』》 / 一列(一直線)に延びている / (動植物が)分布している / 《副詞[句]を伴って》(ある状態に)…を『並べて置く』,配列する,整列させる / …をさまよう,歩き回る(受動態にできない) / 《米》〈家畜〉を放牧地に入れる
rangefinder	(大砲などの)距離測定器;(カメラの)距離計
ranger	歩き回る人 / 《米》森林警備官;《英》(王立公園の)監視官 / 武装警備兵;《『R-』》《米》(第二次世界大戦中の)突撃隊員,レーンジャー隊員
rangy	(人・動物が)やせて足の長い
rani	=ranee
rank	〈C〉〈U〉『階級』,等級;(相対的な)『順位』,地位 / 〈U〉高い地位(身分) / 〈C〉〈U〉(人・物の)『列』,並び;(兵隊)の横列 / 《the ranks》(また『rank and file』)(将校たちに対して)兵卒,下士官 / …を『並べる』 / …を『位置づける』,評価する / 《米》…より上位にある / 『位置する』・「pull one's rank on 誰々」で「(誰々に)地位を悪用する; (意見が衝突したような場合に)階級をかさに着て(誰々に)命令を押しつける」 / (植物が)おい茂った,はびこった / (土地が)植物をおい茂らせた,肥えすぎた;(土地が)(植物を)おい茂らせた《+『with』+『名』》 / 悪臭を放つ,いやな味のする / 全くの,ひどい
rank and file	(the ～) (単複両扱い) 兵卒; 大衆; 平社員・(指導者を除いた)一般人
rank-and-file	平社員の; (指導者でない)一般組合員の; 庶民・一般大衆の; (将校ではない)一兵卒の
ranker	並べる人,分類(評価)する人 / 《英》下士官上がりの将校
ranking	上位の,一流の,卓越した
rankle	〈つらい思い・怒りなどが〉心をさいなみ続ける;〈苦痛・きずが〉長くうずく / 〈人・心など〉を苦しめる
ransack	(物を求めて)〈物の中・場所など〉をくまなく深す,深し回る《+『名』+『for』+『名』〈物〉》 / 〈町など〉を略奪する;〈場所〉をあさって(物を)奪う《+『名』〈場所〉+『of』+『名』〈物〉》
ransacker	略奪者
ransom	〈C〉身のしろ金 / 〈U〉(身のしろ金の支払いによる人質などの)解放,釈放 / 〈人質〉を身のしろ金を取って釈放する / 〈人質〉を身のしろ金を払って釈放させる
rant	大げさに言う / …を大げさに言う《『out』+『名,』+『名』+『out』》 / 大げさな話
ranter	熱弁家 / 大ぼら吹き
rantingly	熱狂的に / 大げさに
rap	(…を)『コツン』(『トン』)『とたたくこと』(『音』)《+『on』(『at』)+『名』》 / 《話》(人のしたことに対する)非難,とがめ《+『for』+『名』》 / 《俗》おしゃべり / …をコツン(トン)とたたく / 〈命令など〉をぴしゃりと言う《+『out』+『名』,+『名』+『out』》 / (…を)コツン(トン)とたたく《+『at』(on)+『名』》 / 《俗》互いに気持ちよく話す・〔俗〕 非難(する); 叱る; 〔俗〕 告訴[処罰,逮捕](する); 〔俗〕 おしゃべり(する); 〔米俗〕 ラップ(ミュージック); 〔米俗〕 ラップで歌う・「take the rap」で「甘んじて罰を受ける」 / 少しも(…しない)
rap session	(特にある特定の問題についての)グループ討論
rap sheet	(容疑や前科の)警察記録,前科記録
rapacious	強奪(ごうだつ)する;(特に金銭に対して)貪欲(どんよく)な
rapacity	貪欲(greed)
rape	〈婦女〉を暴行する,強姦(ごうかん)する / 婦女暴行,強姦 / セイヨウアブラナ(羊・豚などのえさになる)
raper	強姦者
rapid	『速い』,『すばやい』,敏速な / (坂などが)急な,険しい / 急流,早瀬
rapid transit	(大都市圏で地下鉄などによる)高速輸送
rapid-eye movement	レム(睡眠中,特に夢を見ている間の眼球の敏速な動き;《略》REM)
rapid-fire	速射の / やつぎばやの,立て続けの
rapidity	急速,敏速;速度
rapidly	『速く』,『すみやかに』
rapier	(フェンシングなどに用いる)細身の両刃の剣
rapiered	細身の剣(rapier)で突き刺れた
rapine	略奪,強奪
rapist	強姦犯人
rapper	(とびらの)ノッカー / コツコツとたたく人(物) / おしゃべり[な人] / 毒舌家,厳しい批評家
rapport	(人との)親密な関係,相互の信頼関係《+『with』(『between』)+『名』》
rapprochement	(国家間の)親善回復,和睦
rapscallion	ごろつき,無頼漢(rascal)
rapt	うっとりとした,没頭した;(…に)心奪われた《+『in』+『名』》
rapture	〈U〉『非常に幸福な』(『うれしい』)『気持ち』,大喜び,有頂天 / 《複数形で》(…について)大喜び,有頂天《+『at』(『about, over』)+『名』》
rapturous	大喜びの,有頂天の;熱狂的な
