resurrection	〈U〉(生命・希望などの)回復,復活,再流行《+『of』+『名』》 / 《the R-》キリストの復活;(最後の審判の日の)万人の復活
resuscitate	〈仮死状態の人〉を生き返らせる,を意識を回復させる
resuscitation	蘇生,意識の回復 / 復興,復活
retail	『小売り』 / 小売りの / 小売りで,小売り価格で / …を小売りする / 《文》…を受け売りで話す / (…の値段で)小売りされる《+『at』(『for』)+『名』》
retailer	小売り商人
retain	…を『持ち続ける』,保持する / …を記憶にとどめる,覚えている / (報酬を払って)〈弁護士など〉を抱えておく
retainer	(中世の召し使いより上位の)家臣,家来 / 弁護士依頼料
retaining wall	擁壁(ようへき),土留壁(どどめかべ)(台地などで土砂くずれを防ぐための壁)
retake	〈戦いで失った地域〉を奪い返す / 〈写真・映画のシーン〉を再撮影する,取り直す / (特に映画・テレビの)再撮影 / 取り直しのシーン
retaliate	(人に)仕返しをする《+『against』+『名』〈人〉》;(…して)復讐(ふくしゅう)する《+『by』 d o『ing』》 / (同じ手段で)…に報復をする
retaliation	(…に対する)仕返し,報復《+『for』+『名』》
retaliatory	仕返しの,報復の
retard	…の進歩(進行)を遅らせる(のろくする)
retardant	緩速剤(化学反応速度を減じる物質) / 遅らせる
retardate	(差別的表現で知的障害者を意味するが使用は避けるべき)
retardation	〈U〉遅延, 遅滞 / 〈C〉遅らせるもの; 妨害物
retarded	知能や情緒の発達が遅れた
retch	むりやりに吐き出そうとする
retd.	retained / retired / returned
retell	…を再び語る;…を言い替える
retention	保持(維持)すること;保持(維持)された状態 / 保持(維持)する力 / 記憶(力)
retentive	保持(保有)する力がある;(…を)保持する《『of』+『名』》
rethink	…を考え直す,再検討する / 考え直すこと
reticence	沈黙がち,無口,口数の少なさ
reticent	言葉が控え目の,口数が少ない;(…について)口が重い《+『on』(『about』)+『名』》
reticulated	網状の,網目でおおわれた
reticulation	〈U〉網目,網状 / 〈C〉《しばしば複数形で》網細工
reticule	(昔の)小物入れ・(網製)手さげ袋; (コンピュータ)レティクル (ICの回路パターンの焼き付けられた原版)
retina	(目の)網膜
retinue	(王侯などの)従者,随行員
retire	(…から)『引退する』,退職する《+『from』+『名』》 / 就寝する,床につく / (…へ)『引きこもる』,退く,立ち去る《+『to』+『名』》 / (…から)…を引退(退職)させる《+『名』+『from』+『名』》 / (野球で)〈打者〉をアウトにする
retired	引退(退職)した;退職者のための / へんぴな,人里離れた,引きこもった
retirement	(…からの)引退,退職《+『from』+『名』》 / 引きこもること,引きこもり
retiring	内気な,引っこみがちの / 退職の
retold	原作を平易に(短く)書き直した
retort	《『retort』+『that節』》(とっさに語気鋭く,また機転をきかせて)…と『言い返す』 / 《文》(人に対して)…を仕返しする《+『名』+『on』(『upon, against』)+『名』〈人〉》 / (…に)言い返す,しっぺい返しをする《+『on』(『upon, against』)+『名』》 / しんらつな応答;当意即妙の返答 / (実験などに用いる)レトルト,蒸留器
retouch	〈絵・写真〉に手を入れる,加筆する,修正する
retrace	…を引き返す / …をさかのぼって調べる(思い出す)
retract	…を引っ込ませる / 〈宣言・約束など〉を撤回する,取り消す / 引っ込む,縮む / (約束などを)取り消す《+『from』+『名』》
retractable	引っ込められる / 取り消しできる,撤回できる
retractile	(カメの頭のように)伸縮可能な
retraction	〈C〉(約束・意見などの)撤回
retread	〈古いタイヤ〉に再び踏面(とうめん)をつける / (新たに踏面をつけた)再生タイヤ
retreat	(…から…へ)『退却する』,後退する《+『from』+『名』+『to』(『into』)+『名』》 / (…から…へ)去る,逃げる《+『from』+『名』+『to』(『into』)+『名』(do『ing』)》 / 〈U〉〈C〉(…から…へ)『退却すること』,退散《+『from』+『名』+『to』+『名』》 / 〈U〉《the ~》退却の合図 / 〈C〉(…からの)隠退所,避難所《+『from』+『名』》
retrench	〈費用など〉を切り詰める / …を削除する,取り除く / 節約する
retrenchment	(費用の)節約,削減
retrial	再試験;再審
retribution	仕返しをすること,報復すること;《特にa ~》(…の)報い,天罰《+『for』+『名』》
retributive	仕返しの,報復の;応報の
retrievable	取り戻せる,回復できる;償い得る
retrieval	再帰,修正;回復[の見込み]
retrieval system	(コンピューターから情報を引き出す)回収システム
retrieve	(…から)…を取り戻す,回収する《+『名』+『from』+『名』》 / 〈罪など〉を償う,〈誤りなど〉を訂正する / 〈猟犬が〉〈獲物〉を捜して持って来る / 〈猟犬が〉獲物を持って来る
retriever	射止めた獲物を持って来るように訓練した猟犬
retroactive	(法令などが)以前にさかのぼって効力を持つ,遡及(そきゅう)する
retrofire	〈逆推進ロケット〉に点火する
retroflex	そり返った / 反転音の(舌先を上にそらせ発音する)
retrograde	後戻りする,後退する / 悪化する / (生物が)退化する / 後退する,逆行する / 悪くなる / 〈生物が〉退化する
retrogress	(元の状態に)後退する,退化する《+『to』+『名』》
retrogression	後退,逆行 / 退化
retrogressive	(元の状態に)後退する,逆行する,退化する;(…に)後退する《+『to』+『名』》
retrorocket	逆推進ロケット
retrospect	回顧,回想
retrospection	回想,追想;回顧,思い出
retrospective	回顧的な,回想の / (法律などが)遡及(そきゅう)して効力を有する
retrousse	(特に鼻が)上向きの
retroversion	後を向く(指す)こと,反転
return	(…から元の場所・状態などに)『帰る』,戻る《+from+名+to+『名』》 / 再び起こる,再発する / (元の持ち主・場所・状態に)…を『返す』,戻す《+『名』+『to』+『名』》 / (同じようなやり方で)(…に対して)…を『お返しする』,…でこたえる《+『名』+『for』+『名』》 / …を公式に報告する,答申する / 〈利子・利益など〉を生む,生ずる / (国会議員などに)…を選出する / 《しばしば引用節を従えて》…と言葉を返す,返答する / 〈C〉(…から…へ)『帰って来ること』,帰還《+『from』+『名』+『to』+『名』》 / 〈U〉〈C〉(…が)再び起ること(来ること);(病気の)再発《+『of』+『名』》 / 〈U〉(…を)戻すこと,(…の)返却《+『of』+『名』》 / 〈U〉〈C〉(…に対する)返礼,返報《+『for』+『名』》 / 〈C〉公式の報告[書],答申,(所得の)申告 / 〈C〉《しばしば複数形で》収入;利潤 / 《英》(国会議員などの)選挙 / 《米》『帰りの』;《英》往復の(《米》roundtrip) / 返しの,返報の
return match	再試合 リターンマッチ 雪辱戦 復讐戦
returnable	返却できる / 返還すべき
returning officer	選挙管理委員
reunion	〈U〉再結合すること / 〈U〉(親しい者たちの)再会,同窓会
reunite	…を再びいっしょにする;再会させる / 再びいっしょになる;再会する
reuse	…を再使用する,再生する
rev	(エンジン・モーターなどの)回転(revolution) / 〈エンジン〉の回転を増す《+『up』+『名,』+『名』+『up』》 / 〈モーターが〉大きな速度で回転する《+『up』》 / 急速に活動する《+『up』》
rev.	revenue / reverse / review / reviewed / revise / revised / revision / revolution / revolving
revalue	…を再評価する / 〈通貨〉を切り上げる
revamp	…を改造する,手直しする
reveal	〈秘密・事実など〉を『明らかにする』,あばく / 〈隠されていた物〉を現す,見せる(show)
revealed religion	(神の啓示を尊重する)啓示宗教
revealing	露出する,暴露する / 暗示的な,示唆に富んだ
reveille	起床ラッパ
revel	(…を)大いに楽しむ《+『in』+『名』(do『ing』)》 / 《古》どんちゃん騒ぎをする / 酒宴,どんちゃん騒ぎ
revelation	〈U〉(隠れた事実などを)『明らかにすること』,暴くこと《+『of』+『名』》 / 『明らかにされたこと』,暴露された事実 / 〈U〉(神の)啓示,黙示 / 《the R-》ヨハネによる黙示録(新約聖書の最後の書;《略》『Rev.』)
reveler,reveller	飲みさわぐ人;道楽者
revelry	飲みさわぎ,歓楽
revenge	〈受けた危害・侮辱など〉に『復讐』(ふくしゅう)『する』;〈人〉の仇(あだ)を討つ / (行為・言葉に対する人への)復讐(ふくしゅう),仕返し;復讐心《+『on』(『upon』)+『名』〈人〉+『for』+『名』〈行為・言葉〉》
revengeful	復讐(ふくしゅう)心に燃えている;復讐の,仕返しの
revenue	〈U〉(国の)『歳入』 / 《複数形で》(財産・投資などからの)収入,所得
revenue officer	税務官
revenue tariff	歳入増加税
reverberant	反響する,鳴り響く
reverberate	〈音が〉響き渡る,鳴り響く
reverberation	反響音
revere	…をあがめる,尊敬する
reverence	〈U〉(…に対する)『崇敬』,『敬愛』《+『for』+『名』》・会釈・《Your (His/Her) R-》・ローマカトリック教の牧師の敬称・尊敬(の念) (for) (We hold him in ～.); 〔古〕 敬礼・(R-) 尊師 (his [your] R-)
reverend	《文》崇敬(敬愛)すべき / 《文》聖職の / 《通例R-》…師(聖職者に対する敬称;Rev.と略し,姓名の前におく) / 牧師,聖職者
reverent	敬けんな,うやうやしい
reverential	敬けんな,うやうやしい
reverie	(楽しいことの)夢想《+『about』+『名』》,空想
