wheeze	〈ぜんそくの人などが〉ゼーゼー(ヒーヒー)と息をする / 〈車などが〉ゼーゼー(ヒーヒー)という音を立てる / …をゼーゼー息を切らして言う《+out+『名』,+『名』+out》 / ゼーゼーすること;その音 / 《俗》冗談;いたずら
wheeziness	息苦しいこと,呼吸困難な状態
wheezy	(特に常習的に)ゼーゼーいう,ゼーゼー音を立てる
whelk	エゾバイ(食用の巻き貝)
whelm	…を水中に沈める / …を圧倒する
whelp	(犬・オオカミ・猫・ライオンなどの動物の)子供 / 《軽べつして》がき,小僧 / 〈動物が〉子を生む
when	《疑問副詞》(句・節を導くこともある)『いつ』 / 《関係副詞》 / 《制限的用法》(…する,…した)『ところの』 / 《非制限用法》『するとその時に』,そしてそれから / 《先行詞を含んで》…『する』(…である,…した) / 『…する』(…である)『ときに』;…すると / 『…するときはいつでも』 / 『…[な]のに』,にもかかわらず / 『…であるから』 / 『もし…ならば』 / 《疑問代名詞》『いつ』 / 《非制限用法の関係代名詞》《前置詞の目的語》《おもに文》そしてそのとき / 《the~》時,日付,場合
whence	《疑問副詞》(句・節を作ることもある)《古》どこから / 《関係副詞》 / 《制限的用法》《まれ》…から…する(した)ところの[場所] / 《非制限的用法》そしてそこから,そしてそのために / 《先行詞を含んで》《まれ》…する(した)ところの場所へ / 《疑問代名詞》《古》どこ[から] / 《関係代名詞》[…から]…する(した)ところの[場所]
whene'er	=whenever
whenever	《時の副詞節を導いて》『…するときはいつでも;』…[する]たびに / 《譲歩の副詞節を導いて》『いち…でも』 / いったいいつ
whensoever	wheneverの強調形
where	《疑問副詞》『どこに(で,へ)』,どういう状態に,どんな点で / 《関係副詞》 / 《制限用法》(…する,した)『ところの』 / 《非制限用法》『そしてそこで』,するとその点で / 《先行詞を含んで》『…する』(…である)『ところ』 / 《場所を表す副詞節を導く》『…する所に(で,へ)』 / 《方向を表す副詞節を導く》…するどこにでも / 《対立・範囲などを表す副詞節を導く》…であるにの / 《疑問代名詞》《文尾に来る前置詞 from, to などの目的語》『どこ』 / 《関係代名詞》《前置詞の目的語》…『する』(…である)『ところの』 / 場所
where'er	=wherever
where's	where is, where has の短縮形
whereabouts	《疑問副詞》どの辺りに,どこに / 《単数・複数扱い》(人・物の)所在,位置
whereas	《対立・対照などの副詞節を導く》…『であるのに反して』,なのに対して / 《文》《理由の副詞節を導く》…なるがゆえに
whereat	《疑問副詞》何に,なんで(at what) / 《関係副詞》 / 《制限用法》[…に]…する[ところの](at which) / 《非制限用法》そこで,すると(whereupon)
whereby	[…の手段によって] / …によって…するところの(according to which)
wherefore	《疑問副詞》どんな理由(目的)で,なぜ(why) / 《関係副詞》 / 《制限用法》…する[理由](for which) / 《非制限用法》その理由で,それゆえに(therefore) / (…の)原因,理由《+of+名》
wherefrom	[そこから]…するところの(from which)
wherein	《疑問副詞》どの点で(in what way);どういう意味で(in what sense) / 《関係副詞》 / 《制限用法》[…で]…するところの(in which) / 《非制限用法》そしてそこに(で)
whereof	《疑問副詞》何の,何について(of what);だれのことを(of whom) / 《関係副詞》[…について]…するところの(of which, of whom)
whereon	《疑問副詞》何の上に(on what) / 《文》《関係副詞》 / 《制限用法》[その上に]…するところの(on which) / 《非制限用法》=whereupon
wheresoe'er	=wheresoever
wheresoever	whereverの強調形
whereto	《疑問副詞》どこへ;何のために / 《関係副詞》[…へ]…するところの(to which)
whereupon	(通常非制限用法)そこで,それから[…する(である)]
wherever	…『する所はどこでも』 / 『どこに…でも』 / 『いったいどこへ』(に)
wherewithal	(何かを行うための)手段,資金《+to do》
wherry	小さなこぎ舟
whet	〈ナイフなど〉を研ぐ,みがく(sharpen) / 〈食欲・関心など〉を刺激する,そそる
whether	《名詞節(句)を導いて》…『かどうか』[ということ];『…かそれとも…か』 / 《whether…or…の形で,譲歩の副詞節(句)を導いて》『…であろうと…であろうと』,…にせよ…にせよ[いずれにしても] / いずれにしても,ともかく(in any case);どうしても
whetstone	と石
whew	=phew
whey	乳清(チーズを作るとき分離される水溶液)
which	《疑問代名詞》《しばしば「of+複数名詞」を伴って》(一定数の人・物・事のうちで)『どちら』,どれ(どの)物 / 《関係代名詞》 / 《制限用法》(…する,…した)『ところの』 / 《非制限用法》(a)『そしてそれは(を)』,それは…だが(b)《副詞的な挿入節を導いて》『…なことには』 / 《先行詞を含んで》『どれでも…なもの』(whichever) / 《疑問形容詞》(句・節を導くこともある)(一定数の物・事のうちで)『どちらの』,どの / 《譲歩節で》《文》『どんな…でも』 / 《関係形容詞》 / 『そしてその(これらの)』 / 《先行詞を含んで》『どちらの(どの)…でも』(whichever)
whichever	《関係代名詞》《先行詞を含んで》『…するどれでも』(どちらでも) / 《譲歩節を導いて》『どちら(どれ)が(を)…でも』 / 《話》《which の強調形として》『いったいどちらが(を)』 / 《関係形容詞》『どちらの(どの)…でも』 / 《譲歩前節を導いて》『どちらの(どの)…が(を)…しても』
whichsoever	whichever の強調形
whiff	〈U〉《しばしば a whiff》(風・煙などの)一吹き;(…の)ほのかなにおい《+of+名》 / 〈C〉《複数形で》(たばこの煙などの)一吸い / 〈C〉《話》小さい葉巻 / 〈たばこの煙など〉を吸い込む,吐き出す / 《英話》いやな臭いがする
whiffletree	遊動棒(馬具の引き綱を結びつける横木)
whiffy	いやなにおいのする,くさい
while	《通例 a while》『時間,』間,(特に)少しの時間 / 『…する間に(は)』 / 《譲歩》『…であるが,』…なのに / 《比較・対照》(…だが)『一方では』 / 《類似・対応》そして[その上] / 《英北東部》《俗》…まで(until)
whilom	《古》以前の,かつての,昔の / 以前,かつて,昔に
whilst	=while
whim	気まぐれ,でき心,むら気
whimper	〈人が〉しくしく泣く,哀れっぽく訴える / …を泣き声で言う;〈…である〉と訴えるように言う《+that 節》 / (恐怖や苦痛の)すすり泣き,哀れっぽい訴え,クンクンと鼻を鳴らす[擬声語]
whimsey	whimsy
whimsical	気まぐれな,むせ気な / 風変わりな,妙な
whimsicality	〈U〉気まぐれ,むら気;風変わり / 〈C〉《通例複数形で》奇行
whimsy, whimsey	〈U〉気まぐれ,奇抜さ,もの好き / 〈C〉(文学などにおける)風変わりな(珍奇な)ユーモア,奇想;奇抜な行動
whin	ハリエニシダ
whine	〈サイレン・子供・犬などが〉悲しそうな声を立てる,鼻を鳴らす / 泣き言を言う,ぐちをこぼす,だだをこねる / …を哀れっぽい声で言う,だだをこねる;〈…である〉と哀れっぽく言う《+that 節》 / すすり泣き,クンクン(ピーピー)いう声 / 泣き言
whiner	哀れっぽい声を出す人(犬),すすり泣く人;ぐちをこぼす人
whinny	〈馬が〉いななく / (馬の)いななき
whip	『むち』;《比喩的に》訓練のむち / (キツネ狩りの)猟犬係 / (政党所属議員の出席を督励する)院内幹事 / ホイップ(泡立てた卵の白身かクリームで作るデザート) / 〈人・動物〉を『むちで打つ』,にむちを当てる / (人・動物に)…をむち打って教え込む《+名+into+名》;(…から)〈悪癖など〉をむちでやめさせる《+名+out of+名》 / 《方向・状態を表す副詞[句]を伴って》〈物〉を『ぱっと動かす』 / 〈布の縁〉をかがる;〈棒・ロープの端〉に糸(ひも)を巻きつける,を端止めする / (むちで打つように)…をピシッとたたく,たたきつける / 〈卵・クリームなど〉をかき回して泡立てる / 《話》(競技などで)…を打ち負かす / 〈川・湖など〉で投げ釣りをする / 〈こま〉をひもを打ちつけて回す / 《方向・状態を表す副詞[句]を伴って》〈人が〉急に動く(行く,来る,通る) / 〈旗などが〉はためく / 《方向を表す副詞[句]を伴って》〈風・雨が〉激しく打つ,しの突くようにたたきつける
whip hand	支配的地位,権力
whip round	《英》寄付集め,募金
whipcord	むち縄,強くよったひも / あやうね織物
whiplash	〈C〉むち先,むちひも / 〈U〉ぎょっとすること / 〈U〉(また whiplash injury)むち打ち症 / をむち打って励ます
whipper-in	(キツネ狩りの)猟犬係
whippersnapper	こしゃくなやつ,生意気な若僧
whippet	ホイペット(小型の競走犬)
whipping	むちで打つこと,むち打ちの刑
whipping boy	(昔)貴族の子に代わって罰を受けた子供 / (他人の罪を負う)身代り
whipping top	むちごま(むちで回すこま)
whippletree	=whiffletree
whippoorwill	(北米産の)ヨタカの一種
whippy	(茎・枝・棒などが)しなやかな,弾力性のある
whipsaw	糸のこぎり / (二人用の)細身の縦びきのこぎり
whipt	whip の過去・過去分詞
whir, whirr	(モーター,扇風機などの)ブンブン回る音;ヒューヒュー飛ぶ音 / ブンブン回る(音を立てる);ヒューと飛ぶ
whirl	『ぐるぐる回る』,旋回する,渦巻く / 《方向を表す副詞[句]を伴って》(人・動物などが)『急に向きを変える』 / 《方向・状態を表す副詞[句]を伴って》〈人・車などが〉『疾走する』 / 〈頭などが〉くらくらする,めまいがする / …を『ぐるぐる回す』,旋回させる,渦巻かせる / 《方向・状態を表す副詞[句]を伴って》…をさっと運ぶ / 回転,旋回;渦《+of+名》 / 〈U〉《しばしば a whirl》(心などの)乱れ,混乱 / 〈C〉《単数形で》(事件・会合などの)めまぐるしい連続《+of+名》
whirligig	〈C〉回転おもちゃ(こま・風車など) / 〈U〉回転運動;変転
whirlpool	(水流の)渦,渦巻き(eddy)
whirlwind	旋風,つむじ風
whirlybird	《米俗》ヘリコプター(helicopter)
whirr	whir
whish	ピュー(スー)という音 / ピュー(スー)と鳴る(動く)
whisk	(ちりなどを払う)小ぼうき,毛ぼうき / (針金を輪にして組み合わせた)泡立て器 / 《a whisk》(手・はたきなどの)一払い《+of+名》 / …をさっと払うように振る / …を払い落とす;さっと持っていく《+名+off(away),+off(away)+名》 / 〈卵・クリーム〉を泡立てる / 《方向を表す副詞[句]を伴って》さっといなくなる
whiskbroom	(小さなほうき型の)洋服ブラシ
whisker	《通例複数形で》ほおひげ (猫・ナマズなどの)ひげ
whiskered	ほおひげをはやした
whiskey, whisky	〈U〉『ウイスキー』 / 〈C〉ウイスキー一杯
whisper	『ささやく』,ひそひそ話す《+about+名》 / 〈風・流れ・木の葉などが〉サラサラ音を立てる / …を『ささやく』,ひそひそと言う / 《しばしば受動態で》〈秘密など〉を言いふらす《+about+名》 / 『ささやき』,ささやかれた言葉 / 《単数形で》(風・流れなどの)サラサラいう音 / うわさ,ひそひそ話
whispering	ささやく[ような],小声で話す / ささやくような音(声) / ひそひそ話,うわさ
whispering campaign	中傷戦術(デマやゴシップを意図的に流して相手を陥れる組織的な攻撃)
whist	ホイスト(四人二組に分かれてするカードゲーム;今のブリッジの前身)
whistle	『口笛を吹く』;口笛を吹いて合図する / 『口笛のような音を出す』;笛を鳴らす;〈鳥が〉ピーピー鳴く / 《方向を表す副詞[句]を伴って》〈弾丸・風などが〉『ピューと音を立てて飛ぶ』,ヒューと吹く / 〈曲など〉を『口笛で吹く』 / 《方向を表す副詞[句]を伴って》…に『口笛で合図をする』 / 〈矢・銃弾など〉をヒューと放つ / 〈C〉『口笛;警笛』,汽笛;ホイッスル / 〈U〉〈C〉(笛・風・鳥などの)ピューという音《+of+名》
whistle stop	《米》鉄道沿線の小さい町,急行列車の止まらない小さい駅 / (遊説途中での)短期の立ち寄り
whistling	口笛(笛)を吹くこと;ピュー(ヒュー)と鳴る音
whit	微量(bit)
white	〈U〉『白』,白色 / 〈U〉〈C〉白いもの;(特に)『卵の白身』 / 〈U〉『白衣』,白色の服;《しばしば複数形で》白の制服(運動着など) / 〈C〉白人 / 『白い』,白色の,純白の / (恐怖で人・顔・唇などが)『青白い』,血の気のない(pale) / (皮膚の色の)白い,白人の / (髪・ひげなどが)銀色の,白色の / 雪のある,雪の積もった / 《おもに古》潔白の,罪のない / 《英》(コーヒーが)ミルク入りの / …を白くする,漂白する
white alloy	=white metal
white ant	シロアリ=termite
white bear	白クマ
white blood cell	〈C〉白血球
white coffee	ミルクコーヒー
white corpuscle	=white blood cell
white dwarf	白色矮星(小体積で密度の極めて高い末期の星)
white elephant	白象 / 無用の長物,持て余し物
