catch	…を『捕らえる』,捕まえる・〈動いている物〉を『つかみ取る』,受け止める・〈列車など〉に『間に合う』;追いつく・《おもに受動態で》〈あらしなどが〉…を襲う・…を偶然見つける,に思いがけなく出くわす・《副詞[句]を伴って》〈人・動物など〉を打つ・〈打撃・石・風などが〉…に当たる・(…に)〈人〉に〈打撃など〉を与える《+『名』〈間〉+『名』(直)+『on』+『名』》・〈伝染性の病気〉に『かかる』,感染する;(火が)…に燃え移る・(くぎなどに)…を引っかける,(網などに)…をからませる,(ドアなどに)…をはさむ《+『名』+『in』+『名』》・〈注意・関心など〉を引き付ける・…を聞きとる,理解する・ / …をぐっと抑える,がまんする・〈短い動作〉をす早くする,わずかの間する・《米話》〈劇・テレビ番組など〉を見る,聞く・《副詞[句]を伴って》『引っかかる』,からまる・〈かぎが〉かかる,締まる / (野球で)捕手をする・ / 燃え始める;動き始める / 捕まえること,捕獲 / がっちり捕らえて動かなくする物,(戸の)掛け金,(機械の)歯止め・捕らえた物;捕獲量,(特に)漁獲高 / 手に入れる価値のある人(物),(特に)いい結婚相手・キャッチボール,捕球・(声・息の一時的な)途切れ,詰まり;途切れる部分,断片・《話》(人を引っ掛ける)わな,策略
catch crop	間作(かんさく)[用作物]
catch-22	どうにもならない窮地, ジレンマ, 苦境・どうしようもない[にっちもさっちもいかない]状況、[状態]、板挾み、矛盾した状況、金縛り状態、絶体絶命、お手上げ、不条理な状況
catch-as-catch-can	どんな機会も利用する
catchall	がらくた入れ
catcher	『捕らえる人』(『物』) / 『捕手』 / (捕鯨の)キャッチボート
catching	(病気が)うつりやすい,伝染性の / 人を引きつける,魅惑的な
catchment	〈C〉貯水池 / 〈U〉(貯水池の)水 / =catchment area
catchment area	(また『catchment basin』)(湖・川の)集水区域 / (また『catchment』)通学(通院)区域
catchpenny	きわものの,安ぴかの
catchphrase	標語,キャッチフレーズ
catchup	=ketchup
catchword	宣伝文句;標語(slogan) / (また『guide word』)(辞書・事典などの覧外にある)見出し語,肩見出し
catchy	調子がおもしろくて覚えやすい / 引っ掛かりやすい(tricky)
catechism	〈U〉教義問答;〈C〉教義問答書(問答体で書かれたキリスト教の教義学習書) / 〈C〉(一般に)問答式入門書 / 〈C〉(試験の)一連の質問
catechist	教義問答師 / 問答式教義
catechize,catechise	…に(特にキリスト教の)教義を問答式に教える / 〈人〉に細かく問いただす
categorical	無条件の,絶対的な(absolute),明確な / (論理学で)範疇(はんちゅう)の
categorize,categorise	…を分類する,範疇に分ける
category	(論理学・哲学で)範疇(はんちゅう)(ある体系の中でその内容特質に応じて分けた部門)
catenary	垂曲線,懸垂線
cater	(結婚式・パーティーなどで)(…の)食物を調達する,料理をまかなう《+『for』(『to』)+『名』》 / (…の)要求を満たす,用命に応じる《+『for』(『to』)+『名』》 / 〈結婚式・パーティーなど〉の料理をまかなう,仕出しをする
catercorner,catercornered	対角線上の(diagonal) / 対角線上に,斜めに(diagonally)
caterer	(宴会などの)料理の仕出し屋,まかない人;宴会の世話係
caterpillar	ケムシ,イモムシ(チョウやガなどの幼虫) / 無限軌道式トラクター;(戦車などの)キャタピラー
caterpillar tractor	無限軌道式トラクター
caterwaul	(発情期の猫のように)ギャーギャー言う / いがみ合う / ギャーギャー鳴く声
catfish	ナマズ類の魚
catgut	腸線,ガット(小羊などの腸で作った強いひも・糸で弦楽器の弦,テニスのラケット,外科用縫合糸などに用いる)
catharsis	カタルシス,浄化(特に悲劇や音楽で観客の感情を浄化する効果) / (下剤による)排便,(胃腸などの)洗浄 / (精神分析で)浄化法
cathartic	〈C〉下剤 / {形}浄化を促す / 感情を吐き出させる / 下剤作用のある
cathedral	(bishopが統轄する)『大寺院』,大聖堂,大伽藍(がらん) / (一般の)大教会
catheter	カテーテル,(特に)導尿管(体内液の排出・導入に用いる細い管)
cathode	(電気の)陰極
cathoderay tube	ブラウン管
catholicity	〈U〉(趣味・見解・関心などの)広いこと,包容性;普遍性 / 《C-》=Catholicism
cation	陽イオン,正イオン
catkin	尾状花(カワヤナギ・カバノキなどの花)
catlike	猫のような / ゆだんのない;足音を忍ばせた
catnap	うたたね,仮寝 / うたたねをする
catnip	イヌハッカ(強いかおりの植物;猫がその葉を好む)
cats cradle	あや取り遊び
catsup	=ketchup
cattail	ガマ(沼地に生える背の高いアシに似た植物)
cattily	猫のように / ずるく
cattiness	陰険さ,ずるさ
cattle	(家畜の)『牛』
cattle cake	家畜の飼料
cattleman	牛飼い / 牧畜業者
catty	猫のような / ずるい,陰険な;意地の悪い
cattycornered	=cater-cornered
catwalk	(橋・航空機内などの)狭い通路
caucus	(政党・団体などの)幹部会議 / 幹部会議を開く
caudal	(動物の)尾部の;尾状の
caught	catchの過去・過去分詞
cauldron	=caldron
cauliflower	カリフラワー,花キャベツ
cauliflower ear	外傷などで変形した耳
caulk	〈継ぎ目〉にアスファルト(麻くずなど)をつめる
causal	原因の,原因となる,原因を示す
causality	作因;因果関係,因縁
causation	引き起こすこと,原因となること / =causality
causative	原因となる / (文法で,動詞が)使役的な / 使役動詞
cause	〈U〉『原因』,起因;〈C〉原因となる人(物事) / 〈U〉『正当な理由』,根拠,動機 / 《the~》(…という)(身を捧げるべき)主義,主張,目的《+『of』+『名』》 / 〈U〉〈C〉訴訟[の理由];申し立て / …を『原因となる』,を引き起こす,もたらす(bring about)
cause celebre	世の注目を集める論争(論判)
causeless	原因のない;理由のない,いわれのない
causerie	閑談,雑談 / 短い随筆(随想),文芸閑話
causeway	あぜ,土手道(低地・湿地・浅海に土を盛り上けて作った道) / (車道より高くした)側道,歩道
caustic	腐食性の,苛性(かせい)の / 痛烈な,きびしい / 腐食剤
caustic lime	生石灰
caustic silver	硝酸銀
caustic soda	苛性(かせい)ソーダ
caustically	痛烈に,しんらつに
cauterize,cauterise	(硝酸銀・焼き鉄などで)〈患部〉を焼く / 〈良心など〉をまひさせる
caution	〈U〉『用心』,注意,慎重さ,用心深さ(prudence) / 〈C〉『警告』(『注意』)『の言葉』(『合図』,『しるし』) / …に『警告する』,用心させる
cautionary	警告の,いましめの
cautious	『用心深い』,慎重な
cautiously	用心深く
cautiousness	用心深さ
cav.	cavalry
cavalcade	(儀式などに出る)騎馬隊,騎馬行列;自動車行列
cavalier	騎士(knight) / だて男;婦人の護衛者 / 《C-》騎士党員(Royalist)(17世紀の内乱で英国王Charles1世を支持した) / 騎士気どりの,傲慢(ごうまん)な / 屈託のない,むとんじゃくな / (女性に)なれなれしい
cavalry	『騎兵隊』
cavalryman	(1人の)騎兵
cave	『ほら穴』,(特に)横穴 / 〈地盤などが〉陥没する / 〈帽子など〉をへこます
cave-in	(土地の)陥没,(建物の)崩壊,(鉱山の)落盤 / 陥没箇所
caveat	(取引き上の)警告,予告 / (裁判で)手続停止要請書
caveat emptor	(商取引きで)買手の危険負担
caveman, cave man	(有史以前の)穴居人 / 《話》荒っぽい人,粗野な人
cavern	地下大洞窟(どうくつ)
cavernous	空洞の / 空洞のような〈C〉
caviar,caviare	キャビア(チョウザメのはらごの塩づけで珍味とされる)
cavil	(…に)やたらにけちをつける,(…の)あらを捜す《+『at』(『about』)+『名』》 / あら捜し,揚げ足取り
caviler	〈C〉あら探しをする人 / つまらないことに文句をつける人
cavitation	〈U〉空洞化 / キャビテーション(液体中の気泡現象)
cavity	へこみ,くぼみ,空洞 / 虫歯の穴 / (人体内の)腔(こう)
cavity wall	防音・防寒用の中空壁
cavort	〈人が〉浮かれてとんだりはねたりする;〈馬が〉はね回る
cavy	テンジクネズミ(南米産)
caw	(カラスの)カアカアという鳴き声 / 〈カラスが〉カアカア鳴く[擬声語]
