complication	〈U〉〈C〉複雑[な状態],紛糾[状態] / 〈U〉(…を)複雑にすること《+『of』+『名』》 / 〈C〉複雑な(やっかいな)事を引き起こすもの /〈C〉合併症, 併発症, 併発, 余病
complicity	(…との)共謀,共犯,連座《+『with』+『名』》
compliment	『賛辞』,ほめ言葉;おせじ / (行為・言葉による)敬意 / 《複数形で》あいさつの言葉 / (…で)〈人〉に敬意を表す《+『名』+『with』+『名』》 / (…について)〈人〉を『ほめる』,にお祝の言葉を述べる《+『名』+『on』+『名』(do『ing』)》
complimentary	あいさつの,お祝いの;賞賛の;おせじの / 招待の,無料の
compline,complin	(特にカトリック教会で,夜の)終祷(しゅうとう)
comply	(要求・命令・規則などに)『従う』,応ずる《+『with』+『名』》
compo	=composition5
component	構成している,成分の / 構成要素,成分
comport	〈自分〉を処する / (…に)似合う,釣り合う《+『with』+『名』》
comportment	《文》ふるまい,態度
compos mentis	精神の健全な
compose	…を『構成する』 / 〈詩など〉を『作る』,書く;〈曲〉を作る;〈絵の構図〉を作る / 〈自分,自分の気持〉を『静める』 / 〈活字〉を組む;…を活字に組む / 〈争いなど〉を解決する,調停する / 詩を作る;作曲する
composed	落ち着いた
composer	作曲家
composing stick	植字盆(植字工が拾った活字をのせる)・(印刷)ステッキ
composite	合成の,複合の / キク科の / 合成物,複合物 / キク科植物
composition	〈U〉(文学・美術・音楽作品などの)『創作』,制作[法];『作文』,『作曲』,〈C〉作品,楽曲 / 〈U〉(混合物などの)『成分』《+『of』+『名』》 / 〈C〉〈U〉(人の)気質,性質,性分(constitution) / 〈U〉(文学作品・音楽作品などの)構成,構想,(絵画などの)構図《+『of』+『名』》 / (またcompo)〈C〉混合物,合成物 / 〈U〉(活字の)植字,組み
compositor	植字工
compost	〈C〉混合物 / 堆肥(たいひ),混合肥料 / …に堆肥を施す / …を堆肥にする
composure	落ち着き,沈着,平静
compote	(果物や菓子を盛る)足付き皿 / 〈U〉コンポート(果物の砂糖煮)
compound	(…になるように)〈要素・成分など〉を混ぜ合わせる《+『名』+『into』+『名』》;(…から)〈薬など〉を調合する,混ぜ合わせて作る《+『名』+『from』(『of』)+『名』》 / 《しばしば受動態で》〈めんどうな事・損害など〉をもっとひどくする / 〈利子〉を複利で計算する / (…と)話し合いをつける,妥協する《+『with』+『名』》 / 複合の,合成の / 『合成物』,混合物,調合物;化合物 / 複合語,合成語(classroom, heart-to-heartなどをいう) / (異民族の家屋・商館などがある)囲み地区,構内
compound eye	(昆虫の)複眼
compound fracture	複雑骨折
compound interest	複利
compound leaf	複葉(1枚が小葉の集合による葉)
compound sentence	重文(and, butなど等位接続詞または句読点で二つ以上の節が結ばれた文)
comprehend	〈性質・意味など〉を『理解する』 / …を包含する,含む(include)
comprehensibility	理解できること,分かり易さ
comprehensible	理解できる,分かりやすい
comprehension	〈U〉理解 / 〈C〉読解問題
comprehensive	理解力のある,分かりのいい / 包括的な,範囲の広い / 総合制中等学校(11歳より入学,普通科・商業科・工業科がある)
compress	〈ガスなど〉を(…に)『圧搾する』,圧縮する《+『名』+『into』+『名』》 / 〈思想・言語など〉を(…に)要約する《+『名』+『into』+『名』》 / 湿布
compressed air	圧搾空気
compressibility	圧縮性,圧搾できること
compressible	圧縮性の,圧搾できる
compression	圧搾,圧縮;要約
compressor	圧搾ポンプ,圧縮機,コンプレッサー
comprise,comprize	…を包含する,包む(include) / 〈…の部分〉から成る(consist of…) / 〈各部分が〉〈全体〉を構成する
compromise	〈U〉〈C〉(…との)『妥協』,和解,和解《+『with』+『名』》 / 〈C〉妥協案,折衷案;折衷したもの / 〈信用・名声など〉を危うくする,傷つける,汚す / (…と)『妥協する』,和解する《+『with』+『名』》
comptometer	計算機
comptroller	=controller2
compulsion	強制,無理じい
compulsive	強制的な,無理じいの
compulsorily	強制的に,義務的に
compulsory	強制的な,無理じいの / 義務的な,必修の
compunction	良心のかしゃく,悔恨
computation	計算;〈C〉(その結果出た)算定額
compute	…を計算する,見積もる / 計算する,算定する
computer	『計算機』;『電子計算機』
computerize,computerise	…を電子計算機で処理する / …を電子計算化する / 電子計算化される
comrade	(主として男同士の)『仲間』,僚友,同志
comradeship	僚友関係,同志の交わり;友情,同志愛
coms	《話》=combination4
comsat	コムサット(大陸間の通信衛星;communications satelliteの略)
con	反対投票, 反対論 / 〈人〉をペテンにかける (confidence trick) / =convict (誤り)
con artist	ペテン師・詐欺師
con brio	(音楽の演奏の指示で)元気よく,はつらつと
con game	詐欺・=confidence game
con man	ペテン師
con.	continued
conc.	concentrated
concatenate	…を連結する,鎖状につなぐ
concatenation	〈U〉連結すること / 〈U〉連結された状態 / 〈C〉(…の)一連の物事(事件)《+『of』+『名』》
concave	凹(おう)面の,くぼんだ / 凹面
concavity	〈U〉凹状,くぼんだ状態 / 〈C〉凹面
conceal	〈物〉を『隠す』 / (…に)…を『秘密にする』《+『from』+『名』》
concealment	〈U〉隠すこと,隠れること / 〈C〉隠れ場所
concede	(譲歩して)…を『真実と認める』 / 《『concede』+『名』〈間〉+『名』〈直〉=『concede』+『名』+『to』+『名』》〈権利など〉を〈人〉に与える / (…に)譲歩する,(…を)認める《+『to』+『名』》
conceit	〈U〉『うぬぼれ』,自負心 / 〈C〉奇想,気まぐれ,思いつき
conceited	うぬぼれの強い
conceivable	考えられる,想像できる;考えられる限りの
conceivably	考えられるところでは
conceive	〈考え,目的など〉を『心に抱く』,思う,〈計画など〉を思いつく / 《文》〈子〉をはらむ / 《『conceive of』+『名』(do『ing』)》(…を)想像する
concelebrate	ミサの共同執行に加わる
concentrate	(…に)〈光線・注意など〉を『集中する』《+『on』+『名』》 / 〈液体など〉を濃縮する / 《副詞[句]を伴って》(…に)『集中する』 / 専念する《+『on』+『名』》 / 濃縮したもの,濃縮液
concentrated	集中した / 濃縮した
concentration	〈U〉(…への)(光線・注意などの)集中;(仕事などへの)専念,専心《+『on』+『名』》 / 〈C〉(人口などの)集中 / 〈U〉濃縮;〈液体の〉濃度
concentration camp	(政治犯・捕虜などの)強制収容所
concentric	中心を同じくする,同心の
concept	(特に哲学用語として)(…の)概念,観念《+『of』+『名』》,(…という)概念《+『that』節》
conception	〈U〉『概念』,観念,考え(idea) / 〈C〉着想,思いつき,案 / 〈U〉妊娠,受胎
conceptual	概念の
conceptualize,conceptualise	…を概念化する / 概念化する
concern	〈物・事が〉…に『関係する』,かかわる,影響する / 《しばしば受動態で》〈事が〉〈人〉に『関心を持たせる』,を心配させる / 〈小説などが〉…について書かれている(受動態にできない) / 〈U〉〈C〉(…との)『関係』,利害関係《+『in』(『with』)+『名』》;《しばしば複数形で》関係のある事柄,関心事 / 〈U〉(…に対する)『関心』,懸念,心配《+『about』(『over,for,at』)+『名』》 / 〈C〉事業,営業,会社,商会(firm);財閥,コンツェルン / 〈U〉重大な関係,重要性
concerned	《通例名詞の後に用いて》関係のある,かかわりのある / 心配そうな,気づかっている
concernedly	心配して
concerning	…『について』,関して(about)
concert	〈C〉(公開の)『演奏会』,音楽会 / 〈U〉協調,協力
concert pitch	演奏会用標準音高(それぞれの演奏で楽器の音高を合わせる基準)
concerted	協定した,申し合わせた,一致した,共同の / (合唱)用に編曲した
concertgoer	よく音楽会へ行く人,演奏会の常連
concertina	コンチェルティナ(小型の六角形の手摘琴) / 〈車が〉ぺしゃんこになる
concertmaster	コンサートマスター(オーケストラの主席奏者;通例主席第一バイオリニスト)
concerto	協奏曲,コンチェルト
concession	〈U〉〈C〉(要求・結果などに対する)『譲歩』,容認《+『to』+『名』》 / 〈C〉譲歩事項,譲与物 / 〈C〉(政府・土地所有者などが与える)特権,利権;免許 / 〈C〉《米》(公園・劇場などでの)売り場使用権,営業権;営業所
concessionaire	営業権所有者,(場内の)売店営業者
concessive	譲歩的な / (文法で)譲歩の
concessive clause	譲歩節(although, even ifなどで導かれる節)
conch	(ほら貝など,大型の)巻き貝 / (ローマ神話で)トリトン(Triton)のほら貝
