crisscross	十字形,十字模様 / 十字形(十文字)の / 十字形に,十文字に / …に十字を書く;…を交差する / 縦横に動く,交差する
crit.	critic / critical / criticism / criticized
criteria	criterionの複数形
criterion	(価値判断の)規準,尺度
critic	(特に文学・美術・音楽の)『評論家』,『批評家』 / あら捜しをする人,酷評する人
critical	『評論の』,批評の / 批判的な,物を見る眼のある / 『酷評的な』,あら捜しの,手きびしい / 『危機の』,危急の;(病気が)危篤の / 臨界の(温度・圧力などにより物質が急速にその状態を変える境),臨界点における
criticism	〈U〉〈C〉(文学・芸術・一般的な事の)『批評』;〈C〉批評文,評論 / 〈U〉〈C〉『酷評』,非難,あら捜し
criticize,criticise	…を『非難する』,酷評する / …を『批評する』,批判する / 酷評する;あら捜しをする
critique	〈C〉(美術・文芸作品などに関する)評論 / 〈U〉(一般に)論評,批判
croak	(蛙・烏などの)カーカー(ガーガー)という鳴き声;(人の)しわがれ声 / (蛙・烏などが)カーカー(ガーガー)と鳴く / (不吉な感じで)しわがれ声で話す / (特に)〈不満なこと〉を低いしわがれ声で話す
crochet	かぎ針編み / かぎ針編みをする / …をかぎ針編みにする
crock	瀬戸物のつぼ(かめ) / 老いぼれ馬;おんぼろ車 / 老いぼれ
crocked	泥酔した
crockery	瀬戸物類
crocodile	ワニ
crocodile tears	うその涙,そら涙
crocus	クロッカス(英国では早春に咲く;秋咲きのものをsaffronという)
croft	(屋敷続きの)小農園;(家畜数頭を飼育する程度の)小牧場 / (小さな)小作地
crofter	小作農
croissant	クロワッサン(三日月形のパン)
cromlech	環状列石(石を立てて円形に並べたもの;古代イギリス・フランスに見られる) / =dolmen
crone	しわくちゃばばあ
crony	親友,旧友,仲よし(chum)
crook	曲がったもの(道具),かぎ;曲がった部分 / (川・道路などの)屈曲[部],湾曲[部] / (羊飼いが持つ)一端がかぎ状に曲がった杖(羊の後脚を引っ掛けるのに用いる) / 《話》詐欺(さぎ)師,どろぼう / …を屈曲(湾曲)させる,曲げる《+『名』+『up』,+『up』+『名』》 / 屈曲(湾曲)する,曲がる
crooked	『曲がった』,ゆがんだ;(人が)腰の曲がった / 心の曲がった,不正直な
crookneck	首が長くねじれたカボチャ
croon	…を口ずさむ / …を感傷的に口ずさむ,しんみり歌う / 口ずさむ,しんみり歌う / 低く口ずさむこと
crop	〈C〉《しばしば複数形で》『作物』,『収穫物』 / 〈C〉(一地域で一期にとれる農作物の)『収穫』[『高』],生産[高],作柄 / 〈U〉作付け,植え付け,耕作 / 〈C〉《通例単数形で》(同時に,または続々と出てくる人・物の)群れ《+『of』+『名』》 / 〈C〉《通例単数形で》(髪の)刈込み,いがぐり頭 / 〈C〉(鳥の)え袋,そのう / 〈C〉(動物の耳を切って目じるしにする)耳じるし / 〈C〉乗馬むち;むちの柄 / 〈草・毛などの先〉を刈り込む,かみ切る / (…を)…に植え付ける《+『名』+『with』+『名』》 / 作物ができる;作物を植える
crop spraying	=crop dusting
crop-dusting	農薬の空中散布
cropland	耕作に適した土地
cropper	刈り取る人;(特に)刈り込み機 / (ある)収穫を生む作物 / 作物植付け人;物納小作人 (sharecropper) / 作物 / 《特に素嚢の大きい》 ハト
croquet	クローケー(木ヅチ(mallet)で木球を打って数本の鉄製の門柱を通過させて競う戸外の遊び)
croquette	コロッケ
crore	1000万(=100lakhs)
crosier, crozier	crosier,crozier・(bishopやabbotの持つ)笏杖(しゃくじょう)
cross	〈C〉(昔,罪人のはりつけの刑に用いた)『十字架』 / 《the C-》キリストがはりつけになった十字架;キリスト教の象徴としての十字架 / 〈C〉十字(キリスト教徒が右手で切る) / 〈C〉イエスのために耐える苦しみ,受難 / 〈C〉十字架像;(紋章などの)十字形 / 〈C〉キリスト教信仰;《集合的に》キリスト教徒 / 〈C〉十字記号(crisscross)(+または×) / 〈C〉《修飾語を伴って》十字勲章 / 《『the Cross』》南十字星(the Southern Cross) / 〈C〉(動物・植物の)(…間の)異種交配;雑種《+『between』+『名』+『and』+『名』》 / 〈C〉(ボクシングの)クロスパンチ / (信仰のしるしとして)〈人・自分〉に『十字を切る』 / …を『交差させる』(『する』) / …に『交差させて線を引く』;《英》〈小切手〉に線引きする;…を横線(×印)をつけて消す《+『名』+『out』(『off』),+『out』(『off』)+『名』》 / …を『横切る』,横断する,渡る / 〈心〉をよぎる,にふと浮かぶ / …とすれ違う,行き違う / …を妨げる,のじゃまをする / …を交配する / 『交差する』,交わる / (…へ)『横切る』,渡る《+『over to』+『名』》 / すれ違いになる / 〈動物・植物が〉交配する,雑種になる / おこりっぽい,ふきげんな / (風が)反対の / 十文字に交差した,横切った
cross bun	=hot cross bun
cross-country	山野(森林,畑)を横断する / 国の端から端の / クロスカントリー競走
cross-cultural	異種文化間に共通の,通文化的
cross-examination	反対尋問(訴訟の相手方の証人に尋問すること) / きびしい追求,詰問
cross-examine	〈相手方の証人〉に反対尋問する / …を厳しく追求(詰問)する
cross-eye	斜視;〈C〉(特に)寄り目
cross-eyed	斜視の;寄り目の
cross-fertilization	他花(異花)受精
cross-fertilize	…を他花(異花)受精させる
cross-file	二つ以上の政党の予備選挙に候補として登録する
cross-grained	(木材の)木目の不規則な / 根性のねじけた
cross-hatching	細かい平行線の交差によって陰影を入れること; あや目陰影の効果
cross-index	(本・規事など)に相互参照をつける,資料索引をつける
cross-legged	足を組んだ;あぐらを組んだ
cross-ply	(自動車のタイヤが)ゴムの中にワイヤを張って強化された
cross-pollinate	=cross-fertilize
cross-purpose	矛盾した(相反する)目的
cross-question	=cross-examine
cross-refer	…を相互参照させる / 相互参照する
cross-reference	(同一書物中での)前後(相互)参照
cross-section	横断面;[横]断面図 / (全体の特徴・傾向を示す)代表的断面(側面)
cross-stitch	(縫い物・編み物で)クロスステッチ,千鳥掛け,十字縫い / …をクロスステッチにする
cross-town	町を横切っている(走る)
crossbar	(ラグビー・フットボールなどのゴールの,走り高飛び・棒高跳びの)バー,横木 / 横線
crossbeam	(建物の)横はり,横げた
crossbenches	(英議会の)無所属議員席
crossbones	交差した大腿(だいたい)骨の図柄
crossbow	(中世の)石弓
crossbred	雑種の,[異種]交配によってできた
crossbreed	…を[異種]交配させる,雑種にする / 交配種,雑種
crosscheck	〈計算〉を別のやり方で検算する,〈データなど〉を種々の情報(方法)で確かめる
crosscurrent	(海・川などで)逆流 / 相反する傾向,反主流
crosscut saw	横びきのこぎり
crosse	クロス(ラクロス(lacrosse)競技用のラケット)
crossed	(十字形に)交差した / 十字を引いてある,線引きの
crossfire	(2地点以上からの)十字砲火,集中攻撃 / (質問などの)激しい応酬 / (野球の投球で)クロスファイヤ(ホームベース上を斜めに横ぎる球種)
crosshairs	十字線(望遠鏡などの照準を合わせるための十字型の印)
crosshatch	…に網目状の陰影をつける
crossing	横断,横切ること;渡航 / 交差点,十字路;踏切,《英》横断歩道(《米》crosswalk),(河川・水路の)横断場所 / 異種交配(crossbreeding)
crossly	ふきげんに,むっとして;すねて / 逆に,不利に / 横に,斜めに
crossness	ふきげん,片意地,ひねくれ
crossover	《おもに英》(列車の軌道変更のための)渡り線 / 高架交差道(橋) / 支持政党を変えて投票する人 ・= cross-over:クロスオーバー、横断歩道、交差、踏み切り、乗り換え、渡り線・重なる[重複する]部分・いろいろな世界にまたがるもの
crosspatch	《おどけて》気むずかし屋
crosspiece	横材,横木,桟(さん)
crosspollination	=cross-fertilization
crossroad	(他の道路と交わる)交差道路;(本通りと交差する)横通り / 《複数形で》《単数・複数扱い》交差点,十字路 / 《複数形で》《単数・複数扱い》(事態の)重要な岐路
crosstalk	(会議中などでの)むだ話,おしゃべり / (ラジオ・電話などでの)混信,混線
crosstree	クロスツリー(マスト上部の横木)
crosswalk	横断歩道
crossway	=crossroad
crosswind	(進行方向に対し)直角に吹く風,横風
crosswise	横に,はすに / 十字形に / 逆に,逆らって
crossword	クロスワードパズル
crotch	木のまた / (人・ズボンの)また
crotchet	気まぐれな(とっぴな)考え,奇想・小型の掛けかぎ / 4分音符 (《米》 quarter note)
crotchety	(人・考え方が)気まぐれな,風変わりな,気むずかしい
crouch	『うずくまる』,かがむ,しゃがむ;(レスリング・ボクシングなどで)身をかがめる / 〈頭・上半身など〉をかがめる / うずくまること;身をかがめた体勢 / ぺこぺこすること
croup	クループ(せきや呼吸困難を伴う小児病) / (馬の)しり
croupier	(賭博のテーブルで金を集めたり払ったりする)元締め
croupy	クループの(にかかった)
crouton	クルトン(焼くか揚けたパンの小片でスープに入れる)
crow	『カラス』 / =crowbar / 《単位形で》おんどりのかん高い鳴き声 / 〈C〉《通例単数形で》キャッキャッという赤ん坊の笑い声 / 〈おんどりが〉ときを告げる / 〈赤ん坊が〉キャッキャッと笑う / (一般に)〈人が〉誇らしげに歓声をあげる
crow's-foot	目じりのしわ
