Marconi	マルコーニ(『Guglielmo』 Marconi;1874‐1937;無線電信を発明したイタリアの電気学者)
Mardi Gras	告解(ざんげ,食肉)火曜日(Lentの始まる前日で,謝肉祭の最終日)(Shrove Tuesday)
Marian	聖母マリアの
Mariana Islands	《the ~》マリアナ諸島(フィリッピン諸島東方にある15の小島から成る列島でGuam島を含む)
Marie Antoinette	マリーアントワネット(1755‐93;Louis16世の王妃で,フランス革命のとき処刑された)
Marine Corps	米国海兵隊
Marineland	マリンランド(水族館を中心とする公園)
Maritime Provinces	(カナタの)大西洋岸地域(Nova Scotia, New Brunswick, Prince Edward Islandの3州)
Mark	聖マルコ(『St.~』;4人の福音書の記者の一人) / 新約聖書の「マルコによる福音書」
Mark Twain	マークトウェイン(1835‐1910;米国の作家;本名Samuel Langhorne Clemens)
Mars	マルス(ローマ神話の戦争の神;ギリシア神話のAresにあたる) / 火星
Marseilles	マルセーユ(地中海沿岸にあるフランス第2の都市で商港)
Marshall Plan	マーシャルプラン(第二次大戦後,米国務長官George C.Marshallの提唱した欧州復興計画)
Martian	火星の,火星人の / 火星人
Marx	マルクス(『Karl~』;1818‐83;ドイツの経済学者・哲学者)
Marxism	マルクス主義,マルキシズム
Marxism-Leninism	マルクスレーニン主義(共産主義の基盤となる理論)
Marxist	マルクス主義者 / マルクスの;マルクス主義の
Mary	聖母マリア(また『Virgin Mary, Saint Mary』)
Mary Jane	マリファナ(marijuana)
Mary Magdalene	(また『Mary of Magdala』)マグダラのマリア(イエスによって改心した聖書中の女性)
Maryland	メリーランド州(米国東部の州;州都はAnnapolis;《略》『Md.,MD』)
Mason Dixon line	メイソンディクソン線(ペンシルバニア州の南部の州境;昔のアメリカ合衆国を北部と南部に分ける線)
Masonic	フリーメーソン(Freemason)主義の
Mass.	Massachusetts
Massachusetts	マサチューセッツ州(米国北東部の州;州都はBoston;《略》『Mass.,MA』)
Master Chief Petty Officer	(米国海軍の)特務曹長
Master Gunnery Sergeant	(米国海兵隊の)特務曹長
Master of Arts	文学修士号(《略》『M.A.』また『A.M.』)
Master of Hounds	キツネ狩りの総指揮者
Master of Science	理学修士号(《略》『M.S.』)
Matt.	Matthew
Matterhorn	マッターホーン(アルプス山脈の高峰)
Matthew	聖マタイ(『St.~』;4人の福音書の記者の一人) / 新約聖書の「マタイによる福音書」;《略》『Matt.』
Maundy Thursday	洗足木曜日,聖木曜日(復活祭の前の聖週間中の木曜日;キリストの晩餐(ばんさん)を記念する日)
Maupassant	モーパッサン(『Guy de~』;1850‐93;フランスの作家)
Mauritania	モーリタニア(アフリカ北西部のイスラム教共和国)
Mauritius	モーリシャス(インド洋の西部,モーリシャス島および周辺の小島を含む独立国) / モーリシャス島
May	『5月』
May Queen	5月の女王(5月祭の舞踏・競技などの女王に選ばれた少女)
May apple	ミヤオソウ(黄色で卵型の果実を結ぶアメリカ産食用草本)
May day	五月祭(春の到来を祝う5月1日の祭り;広場にMaypoleを建てMay Queenを選んで踊り楽しむ) / メーデー,労働祭
Maya	〈C〉マヤ人 / 《the~》マヤ族(16世紀以前メキシコ南部および中米にマヤ文明を作った中米インディアン) / 〈U〉マヤ語 / マヤ人の / マヤ族の,マヤ文化の,マヤ語系の
Mayflower	メイフラワー号(1620年Pilgrim Fathersを乗せて英国から新大陸へ渡った船)
McCarthyism	マッカーシズム(米国で共産主義者を追放しようとした運動)
McCoy	[the real ～ で] 《口語》 (高品質の)本物,逸品; (亜流でない)本物の人,正真正銘の人
McKinley	マッキンレー山(『Mount』(『Mt.』)~;アラスカ州中南部にある北米の最高峰(6192m))
Md	mendeleviumの化学記号
Md.,MD	Maryland
Me.,ME	Maine
Mecca	メッカ(Saudi Arabiaの商業都市;Muhammadの誕生地でイスラム教の霊地) / 〈C〉《しばしばm-》行ってみたい(あこがれの)所;(…の)発祥地《+『of』(『for』)+『名』》
Medicaid	医療扶助(一定限度の収入しかない人に対する,州または連邦の医療保険制度)
Medicare	老人医療保障制度(米国・カナダでは65歳以上)
Medieval Latin	中世ラテン語(A.D.700‐1500ごろに,特に文学で用いられたラテン語)
Medina	メジナ(Saudi Arabia西部の都市;Muhammadの墓があり,Meccaとともにイスラム教徒の聖地とされる)
Mediterranean	=Mediterranean Sea / 地中海地方 / 『地中海の』;地中海地方[の住民]特有の
Mediterranean Sea	『地中海』
Mekong	メコン川(南シナ海に注ぐ東南アジアの大河)
Melanesia	メラネシア(オーストラリアの東,南太平洋上の群島の総称)
Melanesian	メラネシアの;メラネシア人(語)の / メラネシア人;〈U〉メラネシア語
Melba toast	メルバトースト(かりかりに焼いた薄切りのトースト)
Melbourne	メルボルン(オーストラリア南東部Victoria州の首都で海港市)
Member of Parliament	(英国の)下院議員(《略》『M.P.』)
Memorial Day	(米国の)戦死将兵記念日(南北戦争以後の戦死者の墓を花で飾る;最初5月30日に行われたが,今では大多数の州で5月の最終月曜日)
Memphis	メンフィス(Tennessee州南西部ミシシッピー川流域の港市)
Mendel	メンデル(『Gregor~』;1822‐84,オーストリアの遺伝学者)
Mendelian	メンデルの法則の,メンデルの
Mendelssohn	メンデルスゾーン(『Felix』 ~;1809‐47;ドイツの作曲家)
Menelaus	メネラーオス(ギリシア神話で,スパルタの王でHelenの夫)
Mennonite	メノー派教徒(兵役・宣誓を拒否し質素な生活を営むキリスト教福音教会の一派)
Mephistopheles	メフィストフェレス(中世ドイツ伝説の悪魔;特にゲーテの詩劇「ファウスト」(Faust)で有名) / 〈C〉悪賢い人
Mercator projection	メルカトル[投影]図法(地図製作法の一種)
Mercurochrome	マーキュロクローム,赤チン(消毒液の商標名)
Mercury	水星 / 『マーキュリー』(ローマ神話で,商業をつかさどり,神々の使者をつとめた神;ギリシア神話のHermesにあたる)
Merlin	マーリン(アーサー王伝説の中の高徳の魔術師・予言者)
Mesopotamia	メソポタミア(チグリス・ユーフラテス両川の流域の総称で,現在のイラク共和国の大部分を占めていた;古代文明の発祥地)
Mesopotamian	メソポタミアの / メソポタミア人
Mesozoic	(地質時代の)中生代 / 中生代の
Messeigneurs	Monseigneurの複数形
Messiah	(ユダヤ教で)メシア(神に約束されたユダヤ人の救い主) / (キリスト教で)救世主たるキリスト / 〈C〉《m-》救世主(平和と繁栄の時代の到来を約束する指導者)
Messianic	救世主の[ような]
Messrs.	Mr(Mr.)の複数形 / messieurs
Met Office	気象庁
Methodism	メソジスト派の信仰(教義,礼拝方式)(メソジスト派は18世紀英国において John Wesley がおこしたキリスト新教の一派)
Methodist	メソジスト教会員 / メソジスト派の;メソジスト教会[員]の
Methuselah	〈C〉メトセラ(旧約聖書の登場人物で,969歳まで生きたとされる)
Mex.	Mexico / Mexican
Mexican	メキシコの;メキシコ人の;メキシコ語の;メキシコ文化の / メキシコ人
Mexican Spanish	メキシコで話されるスペイン語
Mexican War	メキシコ戦争(1846年から1848年にかけて戦われた,アメリカ合衆国とメキシコとの間の戦争)
Mexico	メキシコ合衆国
Mexico City	メキシコシティ(メキシコ合衆国の首都)
Mg	magnesiumの化学記号
Mgr.	Manager / Monseigneur / Monsignor
Miami	マイアミ(米国Florida州南東部大西洋岸の都市で臨海避寒地)
Mich.	Michigan
Michael	天使長ミカエル(旧約聖書「ダニエル書」)
Michaelmas	ミカエル祭(天使長ミカエルを祝って9月29日に行う祭日)
Michaelmas daisy	《英》アスター(秋の初めに青味をおびた赤や桃色の花をつける)
Michelangelo	ミケランジェロ(1475‐1564;イタリアの彫刻家・画家・建築家)
