megahertz	メガヘルツ(ラジオなどの周波数の単位;1秒時につき100万ヘルツ;《略》『MHz』)
megalith	(特に,先史時代の遺物である)巨石
megalithic	巨石遺物の / 巨石を造った先史民族の
megalomania	誇大妄想(もうそう)狂
megalomaniac	誇大妄想狂患者
megalopolis	メガロポリス(いくつかの大都市と隣接する複数の都市から成る大都市圏)
megaphone	メガホン
megaton	100万トン / メガトン(核爆弾の爆発力を測るときに使う単位;TNT火薬100万トンに相当する)
megillah	長ったらしい説明,くどい話
megohm	メグオーム,百万オーム(電気抵抗の単位;《略》『meg』)
megrim	偏頭痛
meiosis	(細胞核の)減数分裂 / 控え目な表現,譲歩表現
melamine	メラミン(白色の結晶でおもに合成樹脂の製造に用いる)
melancholia	憂うつ病,うつ病
melancholic	憂うつな,ふさぎ込んだ / うつ病の,うつ病にかかった
melancholy	憂うつ,もの悲しさ / もの悲しいふんい気 / (人・気持ちが)憂うつな,ふさぎ込んだ / (事柄・話などが)もの悲しい気持ちにさせる,悲しげな
melange,mélange	混合物,寄せ集め
melanin	メラニン(皮膚・毛髪などに見られる黒色色素)
melanism	黒色症(皮膚や髪に多量の黒い色素の出る病気)
meld	(カードゲームで)〈ある組み合せのカード〉を見せて得点を宣言する / 得点宣言をする / 得点になる組合せ
melee,mêlée	《単数形で》乱闘
meliorate	…を改善する,改良する / 改善される,良くなる
melioration	改良,改善
meliorism	社会改善論(人間は努力によって世の中を改善できるという信念)
mellifluent	(声・音楽など)甘く滑らかに流れる
mellifluous	(声・音楽などが)流れるような,甘美な,みつのように甘い
mellow	(果実が)『熟して甘い』,よく熟した / (ワイン・チーズなど)ほどよく熟成した;こくのある,芳醇(ほうじゅん)な / (性格などが)円熟した,円満な / (声・音が)柔らかく豊かな,朗朗とした;(色彩・光などが)柔らかくしっとりとした;(土壌が)肥沃(ひよく)で柔らかい / (特に酔って)愛想のよい,ほろ酔いかげんの / 〈時・日光などが〉〈果実などが〉を熟させる / 〈経験などが〉〈人・人の性格など〉を円熟させる,円満にする / 熟す / 円熟する,円満になる
mellowly	熟して,まろやかに
mellowness	芳醇(ほうじゅん),甘美;円熟,成熟
melodic	旋律の,旋律を含む(に関する) / 旋律的(音楽的)な
melodious	美しく聞こえる,調子のよい / 旋律的な
melodrama	〈C〉メロドラマ(感傷的な通俗劇) / 〈U〉メロドラマ的(感傷的)な行為(表現) / 〈C〉(現実の)メロドラマのような情景
melodramatic	メロドラマの(に関する);メロドラマ特有の,メロドラマ的な,メロドラマに適した / メロドラマ作品;メロドラマ的行動(態度)
melodramatically	メロドラマ風に
melody	〈U〉『美しい音の流れ』,快い調べ / 〈C〉『旋律』;(声楽曲・器楽曲の)主旋律[部分]
melon	『メロン』[の実];〈U〉メロンの果肉
melt	(熱・水などによって)『溶ける』,溶解する / 〈人・心・気持ちなどが〉『しだいに和らぐ』 / 〈色・音などが〉(…に)しだいに変わっていく《+『into』+『名』》 / 溶けてしだいに小さくなる(少なくなる,消えていく)《+『away』》 / (熱・水などによって)(…に)〈物〉を『溶かす』,溶解する《+『名』+『in』+『名』》 / 〈心・気持ちなど〉をしだいに和らげる / …をしだいに無くする
melt water	雪解け水
melting point	(固体の)融解点
melting pot	(金属などを溶かす)るつぼ / (人種・文化の)るつぼ(いろいろな人種・考えの人が同居して一つの文化を作っている所)
mem.	member / memoir / memorial
member	(集団の)『一員』,会員,メンバー《+『of』+『名』》 / 《またM-》国会議員 / (数式の)項,辺 / 《文》身体の一部;(特に)手,足 / 《遠回しに》男根
membership	〈U〉(団体の)一員(成員,メンバー)であること / 〈C〉《単数形で》(団体・組織の)全会員 / 《単数形で》(団体・組織の)構成員の数,会員数
membrane	(生物の)膜,皮膜
membranous	膜の;皮膜に似ている
memento	(人・事物を)思い出させるもの,形見,記念品,思い出の種
memo	メモ,覚え書き / (会社内などの)連絡メモ
memoir	〈C〉《複数形で》回顧録;自叙伝 / 〈C〉研究記録,論文
memorabilia	記憶する価値のある事柄(事件);備忘録
memorable	忘れられない,記憶に値する / 注目すべき,きわだった
memorably	忘れ得ずに
memoranda	memorandumの複数形
memorandum	メモ,覚え書き / (会社内などの)連絡メモ,回覧,回報 / (契約・取引きなどの条件の)要約,摘要書;(会社の)定款(ていかん)
memorial	『記念の』,追悼の / 『記念物』,記念像(碑);記念行事,記念式 / 《通例複数形で》(歴史の)記録,年代記 / 《まれ》(政府,議会などへ出す)請願書,陳情書
memorialize,memorialise	…を記念する / 〈政府,議会など〉へ請願書を提出する,請願する
memorization,memorisation	記憶,暗記
memorize,memorise	…を『記憶する』,暗記する
memory	〈C〉〈U〉『記憶』[『力』] / 〈C〉『思い出』,思い出の人(物,事) / 〈U〉《the~》記憶している期間 / 〈C〉死後の名声
men	manの複数形
men's room	男子用手洗所(《英話》Gents)
men-at-arms	man-at-armsの複数形
menace	〈U〉(…に対する)『脅迫』,威嚇(いかく);〈C〉(…を)おびやかす人(物)《+『to』+『名』》 / 〈C〉《話》やっかいな人(物) / …をおびやかす,危険にさらす(threaten)
menacing	脅迫的な,威嚇(いかく)的な
menad	=maenad
menagerie	《集合的に》(動物園の)動物 / 動物園
mend	…を『直す』,修繕する / 〈行い・誤りなど〉を『改める』,改善する / (繕って)元通りになる / 〈病人・けがなどが〉快方に向かう / 修繕箇所 / かがった部分
mendacious	偽りの;うそをつく
mendacity	うそをつくこと,虚偽
mender	修理(改良)者
mendicant	物もらい;托鉢僧
mending	つくろい[物]
menfolk	《話》男たち / 男性の親類
menhaden	ニシンの一種(油や肥料用)
menial	(仕事などが)くだらない / 《古》召使の,召使にふさわしい / 《しばしば軽べつして》召使,奉公人
meninges	髄膜
meningitis	脳膜炎
meniscus	〈C〉三日月形の物体 / 〈C〉凹凸(おうとつ)レンズ / 〈U〉(器の中の液体の表面の)凸面,凹面
menopause	《the ~》(また《話》『change of life』)月経閉止期,更年期
menorah	(ユダヤ教でおもに宮清めの祭り(Hanukkah)に用いる)大燭台
mensch	りっぱな人間, あれー, おやおや
menses	月経
menstrual	月経の
menstrual period	《しばしば複数形で》月経
menstruate	月経がある
menstruation	月経
mensurable	測定できる,測れる
mensuration	《文》測定 / (長さ・面積・体積の)測定法,求積法
menswear	紳士服
mental	『精神の』,心の / 頭脳の,知能の / 《名詞の前にのみ用いて》精神病の / 《名詞の前にのみ用いて》頭の中で行う / 《英話》《補語にのみ用いて》頭のおかしい,気がふれた
mental age	(知能検査によって測定する)精神(知能)年齢
mental defective	精神薄弱者
mental deficiency	精神薄弱
mental hospital	精神病院
mental illness	精神病
mental patient	精神病患者
mental reservation	心中留保(口に出したりせずに心の中にしまっておくこと)
mental retardation	(差別的で使用が推奨されない知的障害を指す表現)
mentalist	=mind reader
mentality	〈U〉精神力,知力 / 〈U〉思考,考え方;性格
mentally	精神的に,知能に関して / 頭の中で,頭を使って
