mini	ミニスカート / ミニカー / (一般に)小型の物
miniature	(…の)『模型』《+『of』+『名』》 / 小さな細密画,(特に)小さくて細密な肖像画 / 小型の,縮小した
miniaturist	細密[肖像]画家
miniaturize	…を小型化する
minibike	小型オートバイ
minibus	小型バス(6人から12人乗り用)
minim	ミニム(液量の最小単位) / 《英》二分音符(《米》half note)
minima	minimumの複数形
minimal	最小の,極小の,最近の
minimize,minimise	…を最小限にする / …を過小評価する,軽視する
minimum	《通例単数形で》『最小限』,最小量 / (数学で)極小,最小値,極小値 / 《名詞の前にのみ用いて》『最小限の』,最小量の
minimum wage	(法律が定めたまたは組合などが協定した)最低賃金
mining	採鉱,鉱業 / 地雷(機雷)の敷設 / 鉱山の,採鉱の
minion	(言いなりになる)手先,取り巻き;お気に入り
miniscule	=minuscule
miniseries	短期連続テレビドラマ
miniskirt	ミニスカート(ひざ上数センチまでの短いスカート)
ministate	極小国家
minister	『聖職者』,牧師 / (英国・欧州諸国・日本の)『大臣』 / (…駐在)『公使』(大使(ambassador)の次の位で,大使が派遣されていない国において自国政府を代表する)《+『to』+『名』》 / (人の)面倒を見る,(…に)尽くす,仕える《+『to』+『名』》
ministerial	聖職[者]の / 内閣の,大臣の
ministering angel	救いの天使(老人・病人の世話をする看護婦など)
ministrant	奉仕者,世話人 / 奉仕する,世話をする
ministration	援助,奉仕 / 牧師の職務,聖職
ministry	〈U〉《the~》牧師の職 / 《the~》《集合的に》聖職者,牧師(clergy) / 〈C〉(英国・欧州諸国・日本などの)『省』;省の建物 / 〈C〉《通例単数形で》大臣(公使)の職(任期) / 〈C〉《しばしばthe M-》『内閣』,閣僚たち
miniver	ミニバー(貴族の礼服に用いられる白い毛皮)
mink	〈C〉ミンク(イタチに似た動物) / 〈U〉ミンクの毛皮(光沢のある茶色で,高価) / ミンクの
minnesinger	(12‐14世紀ドイツの)吟遊詩人,叙情詩人
minnow	ウグイに似たコイ科の小さな魚;魚釣りのえさにされる / 小魚,ざこ
minor	『小さいほうの,少ない』 / (階級・地位・重要性などが)『劣ったほうの』,重要でない / 重大ではない / 未成年の / (音楽で)短調の / 未成年者 / (大学の科目・課程の)副専攻科目 / (音楽で)短調 / 《the minors》《米》=minor league
minor key	(音階の)短調
minor league	マイナーリーグ,小リーグ(野球・アイスホッケーなどの下位のプロスポーツ連盟)
minor planet	=asteroid
minor scale	短音階
minor suit	マイナースート(ブリッジで,ダイヤまたはクラブの組札)
minor third	(音階の)短3度
minority	〈C〉《単数形で》(ある集団または全体を構成する,多数に対する)『少数』,(過半数に対する)半数以下 / (またminority group)〈C〉(人種・宗教・政治の点で)『少数派』,少数グループ,少数民族 / 〈U〉未成年;未成年期
minority government	(野党よりも議席の少ない)少数党内閣
minority leader	(上下両院それぞれの)野党の院内総務
minster	修道院に付属した教会堂 / 大寺院(cathedral)
minstrel	(中世の)吟遊(ぎんゆう)詩人 / minstrel showの出演者
minstrel show	ミンストレルショー(アメリカで始まったバラエティーショー;白人が黒人にふんして歌い,踊り,お笑い寸劇を演じる)
minstrelsy	〈C〉吟遊詩人の芸術や芸能の総称
mint	〈U〉ハッカ / 〈C〉ハッカ入りのキャンデー(ガム) / 〈C〉造幣局 / 〈C〉《a ~》《話》(特に金について)多額,ばく大な量(の…)《+『of』+『名』》 / まだ使っていない / 〈貨幣〉を鋳造する / 〈新造語〉を作り出す
mint julep	ミントジュレップ(バーボンウイスキー・砂糖・かき氷を混ぜハッカを添えた飲料)
mint sauce	ミントソース(砂糖・酢にハッカの葉を刻んで入れた小羊の焼肉用ソース)
mintage	〈U〉化幣鋳造 / 《集合的に》鋳造された貨幣 / 〈U〉貨幣鋳造費 / 〈C〉貨幣の極印(品質証明のために押す)
minuend	被減数,引かれる数
minuet	メヌエット(17世紀フランスで始まった3拍子のゆるやかで優雅なダンス) / メヌエット舞曲
minus	…を引くと,を減ずると / 《話》…なしで,を失って,のない(without) / 『マイナスの』,負の(negative) / 《名詞の後にのみ用いて》…より少し低い(小さい,劣る) / ゼロ以下の / (また『minus sign』)負号,マイナス記号 / 負数
minuscule	非常に小さい,微細な / (中世の写本の)小文学 / (印刷の)小文学
minute	(時間の単位の)『分』(1/60時間;《略》『m.,min.』) / (角度の単位の)分(1/60度;記号は'で,数字の後に付ける) / 〈U〉《しばしばa ~》《話》『瞬間』,ちょっとの間(moment) / (また『minute book』)《複数形で》(会議の)議事録 / 『ごく小さい』,微細な / 『精密な』,詳しい / ささいな,取るに足りない
minute book	=minute
minute gun	分時砲 / 1分ごとにならす弔砲 / 昔の船の遭難信号
minute hand	(時計の)分針,長針
minute steak	即席ステーキ(短時間で料理できる薄切りステーキ)
minutia	(…の)細目,詳細,ささいなこと《+『of』+『名』》
minx	おきゃん,おてんば娘,生意気な娘
miracle	『奇跡』,神わざ / 『驚嘆すべきこと』;(…の)驚異《+『of』+『名』》
miracle play	奇跡劇(キリスト・聖徒・殉教者たちの生涯を扱った中世の宗教劇)
miraculous	奇跡の,奇跡による / 驚くべき,信じがたい / 奇跡を行う力のある
miraculously	奇跡的に,驚くほど
mirage	(砂漠や炎熱した道路などに起こる)蜃気(しんき)楼 / 幻影,幻覚,妄想,幻想
mire	《文》湿地,沼地(bog) / ぬかるみ,深い泥(どろ) / 〈車・馬など〉を沼地(ぬかるみ)にはまらせる / 〈車など〉を泥で汚す / 〈車などが〉沼地(ぬかるみ)にはまる
mirror	『鏡』;(物の)鏡のような面 / (…の)姿を映す物;(…の)反映,手本(example)《+『of』+『名』》 / …を鏡に映す;〈鏡が〉…を映す / (鏡に映すように)…を映し出す,描き出す
mirror image	(鏡に映した左右逆に見える)(…の)鏡像《+『of』+『名』》
mirth	陽気な騒ぎ,笑いさざめき;陽気,愉快
mirthful	楽しい,愉快な,陽気な(merry)
mirthless	愉快でない
miry	泥だらけの;泥沼の
misadventure	不幸,不運(misfortune);〈C〉不運なでき事,災難
misadvise	〈人〉に誤った忠告をする,不適当な助言をする
misalliance	(特に,家柄・身分などが)不釣り合いな結婚
misanthrope, misanthropist	人間(交際)ぎらいの人
misanthropic, misanthropical	人間(交際)ぎらいの,厭世的な
misanthropy	人間ぎらい,人間不信
misapplication	誤用,乱用
misapply	…の適用を誤る,を乱用する
misapprehend	…を誤解する,思い違いをする
misapprehension	誤解,思い違い
misappropriate	〈他人の金・公金〉を着服する,横領する / …を悪用する
misappropriation	乱用,悪用;着服,横領
misbegotten	私生児の,庶出の / (人,計画などについて)卑しむべき
misbehave	無作法にふるまう / 無作法にふるまう
misbehaved	無作法な
misbehavior,misbehaviour	無作法
misc.	miscellaneous / miscellany
miscalculate	…を計算違いをする,見込み違いをする / 計算違い(見込み違い)をする
miscalculation	計算違い,見込み違い
miscall	…を間違った名で呼ぶ
miscarriage	失敗,不首尾,失策(error) / 《英》(手紙などの)配達違い,不着 / 流産
miscarriage of justice	誤審
miscarry	〈人・人の計画などが〉失敗する,しくじる(fail) / 《英》〈手紙などが〉誤って配達される,不着になる / 流産する
miscast	〈役者〉を不適当な役に割りふる;〈劇〉にへたな役のふり当てをする
miscegenation	(異人種間の)混交,混血
miscellaneous	種々雑多な,いろいろ混じった
miscellany	(いろいろな物の)寄せ集め,ごたまぜ《+『of』+『名』》 / 文集,論集,雑録
mischance	不運,不幸,災難 / 不運な(不幸な)でき事
mischief	〈U〉『いたずら』,わるさ / 〈U〉いたずら心,茶目っ気 / 〈U〉(人・動物による)害,危害,損害 / 〈C〉《話》いたずらっ子,わんぱく小僧
mischievous	(子供などが)いたずら好きの,わんぱくな / (目付きなどが)いたずらっぽい,茶目っ気のある / (道徳的に)害をなす,人を傷つける
miscibility	混和しやすいこと,混和性
