pectin	ペクチン,膠素,粘膠質
pectoral	胸の,胸部の / 胸部
pectoral cross	(教会の高位聖職者が胸につける)佩用(はいよう)十字架
peculate	〈公金など〉を使い込む,横領する
peculation	公金横領,官物私用
peculiar	『変な』,奇妙な,変わった / 『独特な』,特有の / 《話》(気分・体が)おかしい,ぐあいが悪い
peculiarity	〈C〉風変わりな点(態度),奇癖 / 〈C〉特色,特性,特質 / 〈U〉(…の)特殊性,特異性《+『of』+『名』》
peculiarly	奇妙に,一風変わって / 特に,格別に
pecuniary	金銭[上]の,金銭による / 罰金に相当する,罰金刑による
pedagogic, pedagogical	教育[上]の,教育学の,教授法の
pedagogue	教師,先生 / 学者ぶる人,物知り顔をする人
pedagogy	教育学,教授法 / 教育,教授
pedal	(自転車・自動車などの)『ペダル』,踏み板 / (ピアノなどの)ペダル,踏み板 / …のペダルを踏む;(ペダルを踏んで)…を走らせる / ペダルを踏む;(ペダルを踏んで)動かす / (人・動物の)足の / ペダルの
pedant	学者ぶる人,学問を鼻にかける人;空論家
pedantic	学者ぶる,学問をひけらかす,衒学(げんがく)的な
pedantically	学者ぶって,物知り顔で
pedantry	〈U〉学者ぶること / 〈C〉もったいぶり
peddle	〈品物〉を行商する,売り歩く / 《軽べつして》〈考え・計画〉を押しつけようとする / 《軽べつして》〈人を傷つけるうわさ〉をまきちらす / 行商する
peddler,pedlar	行商人 / (麻薬などの)密売人
pederast,paederast	(少年に興味を持つ)男色家
pederasty,paederasty	(少年に興味をもつ)男色
pedestal	(円柱・胸像・花瓶などの)台,台座・基礎・根拠・机の袖・根底
pedestrian	『歩行者』(walker) / 《名詞の前にのみ用いて》歩行者の / (文体などが)月並みな,平凡な,ありふれた
pedestrian crossing	横断歩道
pedestrian precinct	《英》歩行者専用道路,歩行者天国
pedestrianism	徒歩;徒歩旅行 / 歩行主義 / (文体などの)散文調,単調
pediatrician	小児科医
pediatrics	《単数扱い》小児科学
pedicab	(特に東南アジアの)輪タク(2人乗りの三輪車)
pedicel	小花柄,小花梗(こう)(大きい花柄から分れて一つの花をつけている小さい花柄) / (昆虫や海洋生物の)柄,肉茎
pedicle	=pedicel
pedicure	足の[指,爪の]手入れ,ペディキュア
pedigree	〈C〉家系,血統;〈U〉優れた家系,名門 / 〈C〉(家の)系図;(家畜などの)血統書
pedigreed	血統の正しい;由緒(ゆいしょ)のある
pediment	ペディメント,ギリシア建築で柱廊の上の三角形の切り妻,破風(はふ) / 戸口(暖炉など)の上の1のような装飾
pedlar	=peddler
pedometer	歩数計,万歩計
peduncle	花柄 / (クラゲ・エビなどの)柄
pee	《俗》小便する,放尿する / 《a~》《俗》小便すること / 〈U〉小便
peek	(…を)こっそりちらっとのぞく《+『at』(『in』,『into』)+『名』》 / 《単数形で》ちらっとのぞき見ること,のぞき見
peek-a-boo	《英》(赤ん坊に対して)いないいないばあ
peel	(果物・野菜などの)『皮』 / 〈果物・野菜など〉の『皮をむく』 / …を取り去る《+『名』+『off』,+『off』+『off』+『名』》;(…から)…をはぎとる《+『名』+『off』(『from』)+『名』》 / (…から)〈皮膚・ペンキなどが〉はげて落ちる《+『from』(『off』)+『名』》
peeler	(野菜などの)皮むきナイフ / 警官
peeling	〈U〉皮むき / 《複数形で》(野菜・果物,特にジャガイモの)むいた皮
peen	金づちの頭(くぎを打つ平らな部分の反対側)
peep	(すき間などから)『のぞき見する』《+『through』+『名』》;(…を)こっそりのぞく《+『at』(『into』)+『名』》 / 〈草花・太陽などが〉出始める,顔を出す / 《しばしばa~》『のぞき見』,かいま見ること / 《the~》(太陽などの)出始め,出現《+『of』+『名』》 / (ひな鳥・ネズミなどの鳴き声の)ピーピー,チューチュー / 《単数形で》《話》不平,泣き言 / ピーピー(チューチュー)鳴く
peeper	のぞき見する人;せんさく好き / 《複数形で》《俗》目 / ピーピー鳴く鳥・ピーピー[チューチュー]鳴く獣[鳥]; ひな・(かん高い声で鳴く) アマガエル科のカエル・めがね・覗(のぞ)き見をする人・(ふつう複数で)目
peephole	のぞき穴
peeping Tom	女性の裸をのぞき見する人,のぞき魔,出歯亀(でばがめ)
peepshow	ピープショー(のぞき穴を通して見せる見せ物)
peepul	インドボダイジュ(菩提樹) = pipal
peer	(…を)『じっと見つめる』《+『at』(『into, through』)+『名』》 / 見えてくる,一部見える《+『out』》 / (地位・階級・年齢・販力などが)『同等の人』,同輩 / (英国の)『貴族』(英国以外の)貴族 / …と肩を並べる,に匹敵する
peer of the realm	(一代貴族に対して)世襲貴族(=hereditary peer)
peerage	《集合的に》貴族;貴族階級 / 貴族の爵位 / 〈C〉(名前・家系などを記した)貴族名鑑
peeress	貴族の婦人;有爵の婦人
peerless	並ぶもののない,無比の;絶世の
peeve	〈人〉をじらす,腹だたせる,悩ます(annoy) / じらす(悩ます)もの
peevish	だだをこねる;気むずかしい
peewee	異常に小さい人(物),ちび / =pewee / ちびっこの,非常に小さい
peewit	=pewit
peg	(木などの,おもに木工に用いる)『くぎ』,掛けくぎ;(たるなどの)『せん』;(テントなどの)『くい』 / (弦楽器の弦をしめる)ねじ / 《話》(評価などの)段階)degree) / (議論などの)きっかけ,口実 / 《話》(おもに野球で)送球 / …を『木くぎ』(『くい』)『でとめる』,に木くぎ(木くいを打つ《+『名』+『down』,+『down』+『名』》 / 〈物価・賃金など〉を仰える,安定させる / 《話》(おもに野球で〈ボール〉を投げる / 《話》…を認める,見定める
peg leg	義足 / 義足をつけた人
pegboard	(ゲームなどに用いる)くぎ差し板 / (くぎなどを差し込む穴のある)構図版
pegmatite	巨晶花崗岩,文象花崗岩(断面に文字模様のついたもの)
peignoir	(婦人用)化粧着,部屋着;(水泳後・湯上りに着る)ガウン
pejorative	軽べつ的な;悪口として用いられる / 軽べつ語,誹謗(ひぼう)語
pekoe	《しばしばP-》ペコー(スリランカ・インド・ジャワ産の高級紅茶)
pelage	(哺乳動物の)毛,毛皮
pelagic	遠洋の,外洋に住む(で行う)
pelf	《通例軽べつして》金銭(money),(不正で得た)富(wealth)
pelican	ペリカン
pellagra	ペラグラ病(皮膚異常・中枢神経機能障害などを起こす)
pellet	(指で丸めたような)小球;小粒 / (空気銃の)小弾丸 / 丸薬,錠剤
pellmell,pell-mell	《まれ》混乱して,めちゃくちゃに;あわてふためいて / めちゃくちゃの;あわてふためいた
pellucid	(ガラス・流れなどが)透明な,澄んだ / (表現・文体が)明りょうな,明白な
pelmet	(カーテン上部の金具をかくす)上飾り(《米》valance)
pelt	〈石など〉を(…に)立て続けに投げる《+『名』〈石など〉+『at』+『名』》;…に(石などを)投げて攻撃する《+『名』+『with』+『名』〈石など〉》 / 〈打撃・砲弾・雨などが〉…を続けて打つ / 〈雨などが〉激しくたたきつけるように降る《+『down』》 / 急いで走る,疾走する / 強打 / (動物)生皮,毛皮
pelves	pelvisの複数形
pelvic	骨盤の
pelvis	骨盤
pemmican,pemican	ペミカン(乾操した肉の粉をこねた保存食料)
pen	〈C〉(インクを用いる筆記具全体をさして)『ペン』;万年筆,ボールペン,フェルトペン;ペン先 / 〈U〉《the~》文筆,著述 / 〈C〉《単数形で》《文》文筆家 / 《気どって》…を書く,著す(write) / 〈C〉(家畜などを入れる)『おり』 / 《集合的に》おりの中の動物 / 〈C〉(監禁・保護に使われる)囲い,幼児用遊びわく(playpen) / (囲い・ありなどに)…を入れる,閉じ込める,監禁する《+『名』+[『up』]『in』+『名』》 / 刑務所[penitentiaryの短縮形]
pen friend	=pen pal
pen pal	ペンパル,文通仲間(《英》pen friend)
pen pusher	《軽べつして》事務員,書記
pen-and-ink	《名詞の前にのみ用いて》ペンで書いた
penal	(特に,法的な)刑罰の / 刑事上の
penal servitude	(強制労働を伴う)懲役
penal settlement	犯罪者植民地,流刑地
penalization,penalisation	有罪;刑罰
penalize,penalise	(法律・規則などで)(…に対して)…を罰する,に有罪の宣告をする《+『名』+『for』+『名』(do『ing』)》 / (競技などで…に対して)…に罰(ペナルティー)を課す《+『名』+『for』+『名』(do『ing』)》
penalty	『刑罰』,処罰 / (ある行為・状態に伴う)不利益 / 『罰金』,違約金,反則金 / (スポーツ・競技で,反則に対する)『罰則』,ペナルティー;(前回の勝者に対する)ハンディキャップ
penalty area	(サッカーの)反則区域
penalty clause	罰則
penance	(罪の償いのための)ざんげ,(罪滅ぼしの)苦行《+『for』+『名』》 / (カトリックで)ざんげの秘跡,告解
pence	pennyの複数形
penchant	(…に対する)強い好み《+『for』+『名』(do『ing』)》
pencil	〈C〉〈U〉鉛筆 / 〈C〉鉛筆状のもの,(棒状の)化粧品 / …を鉛筆などで書く(描く,印をつける)
pendant	ペンダント(首飾り・耳輪などの垂れ飾り) / (屋根・天井などからの)つり飾り;つりランプ,シャンデリア / =pendent
pendent	ぶら下がった,垂れ下がった / 張り出た, 覆いかぶさった / 未決定の / =pendant
