prefabricated house	組み立て式住宅,プレハブ家屋
prefabrication	規格部品による組み立方式
preface	(論文などの)『序文』,『はしがき』;(演説などの)前置き《+『to』+『名』》 / 《話》(行動の)きっかけ,序の口 / (…で)…に序文(前置き)をつける《+『名』+『with』(『by』)+『名』》 / …の前置き(導入)の役を果たす
prefatory	序文の,前置きの
prefect	(古代ローマの)長官,総督;(警察・軍・省庁の)長官,総監 / 《英》(public schoolで)風紀の監督をする上級生
prefectural	(フランス・日本などの)県の,府の
prefecture	(フランス・日本などの)『県』,府 / (フランスで)長官(総監)官邸
prefer	『むしろ』…『のほうを好む』(『選ぶ』) / (法廷なでに)…を提出する,申し出る / 《文》(特に教会などで)〈人〉を(…に)昇進させる《+『名』+『to』+『名』》
preferable	いっそう望ましい,むしろ好ましい;(…より)望ましい《+『to』+『名』(do『ing』)》
preferably	好んで,むしろ
preference	〈U〉〈C〉『好み』 / 〈U〉〈C〉好みの物を選ぶ権利;優先権 / 〈C〉『好みのもの』
preference stock	=preferred stock
preferential	優先の;差別的な
preferment	(稀に教会などで)昇進,登用
preferred stock	優先株(《英》preference stock)
prefigure	…を前もって示す / …を予想する
prefix	接頭辞 / 人名の前につける敬称(Mr.,Dr.,Sirなど) / …に接頭辞をつける / (本・名前などの頭に)〈題・称号など〉をつける,冠する《+『名』+『to』+『名』》
pregnancy	〈U〉〈C〉妊娠の状態(期間) / 〈U〉《文》含蓄
pregnancy test	受胎検査
pregnant	(比較変化なし)『妊娠している』 / 《名詞の前にのみ用いて》含みのある / 《補語にのみ用いて》(…を)いっぱいに含んだ,はらんだ《+『with』+『名』》 / 《文》想像(工夫)に富んだ
preheat	〈オーブンなど〉を使用前に温める(熟する)
prehensile	〈足・尾などが〉巻きついて物をつかむのに適している
prehistoric,prehistorical	有史以前の,先史の / 大昔の,旧式な
prehistory	〈U〉先史時代 / 〈U〉先史学,先史人類史 / 《a ~》(ある状況に至るまでの)いきさつ,経過《+『of』+『名』》
prejudge	…を先入観をもって判断する
prejudgment,prejudgement	予断,速断;予断裁決[例]
prejudice	〈U〉〈C〉(…に対する不当な)『先入観』,『偏見』《+『against』+『名』(do『ing』)》;(…に好意的な)先入観,えこひいき《+『in favor of』+『名』》 / 〈U〉不利益,損害 / (…に対して)…に(不当な)『先入観』(『偏見』)『を抱かせる』《+『名』+『against』+『名』(do『ing』)》;(…に対して)…に(好意的な)先入観を抱かせる《+『名』+『in favor of』+『名』,+『名』+『in』 one's 『favor』》 / 〈立場,見込みなど〉を損なう,だいなしにする
prejudiced	偏見をいだいた,不公平な
prejudicial	先入観(偏見)をいだかせる / 《『be prejudicial to』+『名』》…に有害な
prelacy	〈C〉(大司教など)高位聖職者の職(地位) / 《the ~》《集合的に;《英》複数扱い》高位聖職者
prelate	高位聖職者,高僧(bishop,archbishop,cardinalなど)
prelim.	preliminary
preliminary	『準備する』,『予備の』;前置きの / 《通例複数形で》準備の処置,予備行動,下準備 / 予備試験;前座試合;予選
preliterate	(文化・社会などが)記録(文献)を保存してない
prelude	《通例単数形で》(事件などの)前兆,前触れ《+『to』+『名』》 / プレリュード,前奏曲,序曲 / …の前触れとなる;…の前置きにする / …の前奏曲を奏する / (…の)前触れ(前兆)となる《+『to』+『名』》 / 序曲を奏する
prem.	premium
premarital	結婚前の
premature	時期尚早の,早すぎた / 早計の,早まった / 早産の
premature ejaculation	早漏・早発射精
premed	=premedical / 医学部進学課程の学生
premedic	=premed
premedical	医学部進学課程の
premeditate	…を前もって考える(計画する)
premeditated	意図的な,計画的な
premeditation	前もって慎重に計画すること
premier	『第1位の』;『首席の』(chief) / (フランス・イタリア・日本などの)『首相』
premiere,première	(演劇・映画の)初演,封切 / 〈演劇・映画など〉を初演する,封切る / 〈演劇・映画などが〉初演される,封切られる
premiership	〈U〉首相の地位(職,任期) / 〈C〉《英》プレミアリーグ(特にサッカーの最上位リーグ)
premise	〈C〉(推理を行う上で結論の根拠となる)『前提』;(…という)根拠《+『that節』》 / 《the premises》前述の事項,前述の物件 / 《複数形で》家屋敷,土地建物;敷地,構内 / …を前置きとして(あらかじめ)述べる;…ということを前提とする《+『that節』》
premium	(購買心をそそるための)無料提供品,値引き品,おまけ / 割増し金;奨励金 / (普通以上の)高い価値 / 保険料,保険掛け金
premium bond	割増し償還公債
premolar	小臼歯 / 小臼歯の
premonition	(特によくない)(…の)予感《+『of』+『名』》,(…という)前兆《+『that節』》
premonitory	(不吉な)前触れとなる,警告的な
prenatal	生まれる前の,胎児期の(《英》antenatal)
preoccupation	〈U〉(…への)没頭,夢中,(…に)心を奪われること《+『with+名』》 / 〈C〉没頭(夢中に)される問題
preoccupied	(…に)心を奪われている,気をとられている,夢中の《+『with+名』》
preoccupy	《しばしば受動態で》〈人・人の心〉をいっぱいにする
preoperative	手術前に起こる,手術前の
preordain	〈神・運命が〉…をあらかじめ定める
prep	〈U〉《英話》宿題;予習・準備 / 〈C〉《米話》=preparatory school / ・(形容詞)大学入学準備の・〈動詞〉(に)備えて準備する・(大学進学のための)私立高校に通う・予習する
prep school	=preparatory school
prep.	preposition
prepack	=prepackage
prepackage	〈食品など〉を販売前に包装する
prepaid	prepayの過去・過去分詞 / (運賃・郵税など)前払いの,支払い済みの
preparation	〈U〉《a ~》(…の)『用意』《+『of+名』》 / 〈C〉《複数形で》(…のための)準備《+『for+名』》 / 〈U〉準備されている状態 / 〈U〉《英》宿題;予習 / 〈C〉(調理した)食品,(調合した)薬剤
preparatory	『準備の』
preparatory school	(また《話》prep)《話》(名門大学進学を目的としてその準備をする,おもに全寮制の)私立高校 / 《英》(public schoolへの入学準備を目的とする)私立小学校
prepare	〈物事〉の『準備をする,用意をする』 / 〈人〉に『用意させる,心構えをさせる』 / 『準備する,用意する』,心構えをする
prepared	用意のできた,準備された / 《補語にのみ用いて》《be prepared to do》喜んで…する
prepay	…を前払いする,前納する
preponderance	(数量・勢力などにおいて)まさること;(…の)優勢,優位《+『of+名』》
preponderant	(数量・勢力などにおいて)優勢な,圧倒的な;(…に)まさっている《+『over+名』》
preponderate	(数量・勢力・重要性などにおいて)(…より)優位を占める《+『over』+『名』》
preposition	『前置詞』(《略》『perp.』)
prepositional	前置詞の,前置詞を含む
prepositional phrase	前置詞句(go to church, in front ofなど)
prepossess	《通例受動態で》〈感情・観念などが〉〈人〉に先入観を抱かせる / 〈人〉に第一印象で好感を与える
prepossessing	(人・性格などが)好感を与える,好ましい
prepossession	(…に対する良い・悪い)先入観《+『for』(『against』)+『名』》
preposterous	不合理な(absurd) / (態度・外見が)非常識な,ばかげた(ridiculous)
prepuce	(陰茎の)包皮
prerecord	〈番組の〉の録画(録音)をとる
prerequisite	必須の,あらかじめ必要な,条件として必要な;(…に)必須の《+『for』(『to』)+『名』》 / (…の)前提条件,前もって必要なもの《+『for』(『to』,『of』)+『名』(do『ing』)》
prerogative	(特定の人・階級の)特権,特典
pres.	present
pres.part.	present participle
presage	(…の)前兆,虫の知らせ,予感《+『of』+『名』》 / …の前兆となる;…を予言する
presbyopia	[老人性]遠視,老眼
presbyter	〈C〉(キリスト教の)長老(=elder) / 長老職の聖職者,司祭
presbytery	(教会堂の聖歌隊席裏の)内陣・(長老教会の)中会;中会管轄区域・(カトリック教の)司祭館・(キリスト教)長老会(管轄区)・(集合的) 中会管轄下の全教会; (教会の)司祭席
preschool	《名詞の前にのみ用いて》小学校入学前の,学齢未満の・幼稚園より手前の児童の通う幼稚園予科のような施設(保育園=day-care centerとは異なる)
prescience	予知,先見の明
prescient	予測できる,推測可能な
prescribe	〈守るべき規則・方針など〉を『規定する』,『勧める』,指示する / 《『prescribe』+『名』〈人〉+『名』〈薬〉=『prescribe』+『名』+『for』+『名』》〈人〉に〈薬〉を処方する / 規定する,資示する / (病人・病気に対して)処方を書く
prescribed	定められた / 処方された
prescript	規定,指令
prescription	〈U〉指示(規定)すること / 〈C〉規定,指示 / 〈C〉(薬などの)処方;処方せん;処方薬 / 〈U〉時効;長期間の使用による権利,慣行
prescription charge	処方薬の代金
