promotion	〈U〉〈C〉『昇進』,進級 / 〈U〉(…を)押し進めること,(…の)促進,増進,奨励《+『of』+『名』》 / 〈C〉宣伝商品,促進商品
promotional	昇進の,昇格の / 促進の,奨励の
prompt	(人が)『てきぱきした』,敏速な(quick) / (事が)『てきぱきと行われる』,即刻の / 《補語にのみ用いて》(…に)時間どおりの(punctual)《+『in』+『名』(do『ing』)》 / …を刺激する,促す,かりたてる / (演劇で)〈俳優〉に陰からせりふをつける
prompt box	プロンプター席(客席からは見えない)
prompt copy	=promptbook
promptbook	プロンプター用台本
prompter	プロンプター(せりふを俳優に陰から教える人)
promptitude	敏速,機敏
promptly	『敏速に』,即座に / 時間どおりに
promulgate	〈法律など〉を発布する,公布する / 〈信仰・思想など〉を広める,普及させる
promulgation	発布,公布 / 宣伝,普及
promulgator	公表者,発表者,公布者,普及者
pron.	pronoun / pronunciation
prone	《補語にのみ用いて》傾向がある / うつぶせの,平伏した
prong	(フォーク・くまでの)また;(雄ジカの)枝角(えだづの) / …をフォーク(角など)で刺す(突く);〈土・干し草〉をくまででかく
pronghorn	エダツノレイヨウ(北米西部産のカモシカ)
pronominal	代名詞の,代名詞のような
pronoun	『代名詞』(《略》『pron.』)
pronounce	〈単語・文・音〉を『発音する』;〈単語の発音〉を発音記号で示す / …を『宣言する』,言明する;…を宣告する / 発音する / (…について)判断(判決)を下す《+『on』(『upon』)+『名』》
pronounceable	発音できる / 断言できる
pronounced	はっきりした,明白な;きっぱりした
pronouncement	(…についての)公式の宣言(声明),公式見解《+『on』(『upon』)+『名』》;(…という)公式宣言《+『that節』》
pronto	速く,すぐに
pronunciamento	(スペイン語系諸国の革命党などの)宣言書
pronunciation	『発音』,発音のしかた
proof	〈U〉『証拠』,証明;〈C〉『証拠となるもの』,証拠品 / 〈C〉(真実性・品質などの)試験,吟味 / 〈U〉アルコール性飲料の標準強度 / 〈C〉〈U〉校正刷り(proof sheet);試し刷り,(写真の)試し焼き / 《補語にのみ用いて》(…に)耐えられる,負けない《+『against』+『名』》 / (アルコール飲料など)標準強度の / …を校正する / (…に対して)…を耐久性にする;…を耐水性にする《+『名』+『against』+『名』》
proof spirit	標準強度アルコール飲料
proofread	…を校正する / 校正刷りを読む,校正をする
proofreader	校正係
proofreading	校正
proofsheet	校正刷り
prop	支柱,支え / 支えとなる人(物) / …を支える / (…に)…を寄りかからせる《+『名』+『against』+『名』》 / (劇場の)小道具 / プロペラ
prop man	(芝居の)小道具係
prop.	proprietor
propaganda	(特定の主義・主張の)『宣伝』;宣伝活動
propagandist	(特定の主義・主張を)宣伝する人
propagandize,propagandise	〈主義・主張など〉を宣伝する / 〈人やある国・地域など〉に宣伝する / 宣伝する
propagate	〈動植物・菌など〉を増殖させる,繁殖させる / …を普及させる,広める / 〈音・光など〉を伝える / 〈動植物・菌などが〉増殖する,繁殖する
propagation	(動植物などの)繁殖,増殖 / 伝達,伝播(でんぱ) / 宣伝,普及
propagator	繁(増)殖する物 / 植物の培養家 / 伝道者,宣伝者
propane	プロパン[ガス]
propel	…を推し進める,前進させる / 〈人〉をかり立てる,促す
propellant,propellent	(火器の)発射火薬;(ロケットなどの)推進燃料 / 推進させる,推進体となる
propeller,propellor	(船・飛行機の)推進器,プロペラ
propelling pencil	シャープペンシル(《米》mechanical pencil)
propensity	(好ましくないことに向かう)傾向,性癖《+『to』(『towards, for』)+『名』》;(…する)傾向《+『to』 do,+『for』 do『ing』》
proper	(目的に)『適切な』,ふさわしい / 《文》《補語にのみ用いて》《『be proper to』+『名』》…に固有の,本来備わっている / 基準にかなった,正式の / (行き過ぎるぐらいに)礼儀正しい / 《名詞の前にのみ用いて》厳密な,正確な / 《名詞の後に置いて》厳密な意味での,真の,純粋の / 《名詞の前にのみ用いて》すばらしい,すてきな;《おもに英話》全くの / 全く,すっかり
proper fraction	真分数(2/3,3/8など)
proper motion	(恒星の)固有運動
proper noun	固有名詞
properly	『適切に』,妥当に / 基準にかなって,正式に / 厳密に,正確に / 《英話》完全に,ひどく
propertied	財産(資産)のある
property	動産 / 〈U〉《集合的に》『財産』,資産;所有物 / 〈U〉『不動産』・〈U〉〈具体的にはC〉所有地,地所,土地(建物)・[通例複数形で](演劇)小道具 《劇場では通例 props; 《英》 では衣装も含む》
property man	小道具方
prophecy	〈U〉予言;神のお告げ / 〈U〉予言すること
prophesy	…を予言する,予測する / 予言する,予測する
prophet	(霊感や神の力による)『預言者』 / (将来のでき事を)予測する人,予言する人 / (主義・運動などの)代弁者,唱道者;先覚者 / 《the P-》マホメット(Muhammad)
prophetess	(女性の)預言者,予言者
prophetic, prophetical	予言者の;預言の,予言の,予測の;(…を)預言(予言)する《+『of』+『名』》
prophetically	預言(予言)的に,預言(予言)して
prophylactic	(特に病気などの)予防の / 予防薬;予防器具;コンドーム
prophylaxis	(病気の)予防[法]
propinquity	(時・場所・関係の)近接
propitiate	…をなだめる,の怒りを和らげる
propitiation	なだめること;〈C〉(なだめるための)ささげ物
propitiatory	和解の,なだめる;きげん取りの
propitious	幸運な,好都合の;(…に)好都合の《+『to』(for)+『名』》 / (神が)慈悲深い
propjet	《話》プロペラ付きジェット機
proponent	(…の)提案者,主唱者《+『of』+『名』》 / (…の)弁護者,支持者《+『of』+『名』》
proportion	《the~》(…に対する…の)『割合』,比率《+『of』+『名』+『to』+『名』》 / 〈U〉(…との)『調和』,均衡《+『to』+『名』》 / 〈C〉部分;割り前,分け前 / 《複数形で》大きさ / 〈U〉比例 / …の調和をとる;(…に)…を釣り合わせる《+『名』+『to』+『名』》
proportional	比例の,比例による;(…と)比例として《+『to』+『名』》 / 釣り合った,調和した;(…に)釣り合った《+『to』+『名』》
proportional representation	(得票数で議席数を決める)比例代表制
proportionality	釣り合い[のとれていること],均整
proportionate	釣り合いのとれた,比例した;(…と)釣り合いのとれた《+『to』+『名』》
proposal	〈U〉『提案すること』;〈C〉『提案されたこと』 / 〈C〉結婚の申し込み,プロポーズ
propose	…を『提案する』,申し出る / (地位・役職などに)〈人〉を推薦する《+『名』〈人〉+『for』+『名』》 / …を『計画する』,企てる,もくろむ / (…に)〈結婚〉を申し込む《+『名』+『to』+『名』》 / (…に)結婚を申し込む《+『to』+『名』》
proposer	提案者,発起人,申し込み人
proposition	『提案』,申し出 / 陳述,主張 / (論理学の)命題;(数学の)定理 / 《話》(扱わなければならない)仕事,事柄;相手 / 〈人〉に提案する,事を持ちかける
propound	〈理論・問題など〉を提議する,提出する
proprietary	所有主の / 個人所有の / 資産のある / 専売特許の,独占権をもつ
proprietor	持ち主,所有者;経営者
proprietress	女性の経営者(所有者)
propriety	〈U〉(…の)正しさ,妥当性《+『of』+『名』(do『ing』)》 / 〈U〉礼儀正しさ,作法 / 《the proprieties》礼儀作法
propulsion	推進すること;推進力
propulsive	推進力のある
propylene	プロピレン(無色の引火性ガス)
prorate	〈出費など〉を比例配分する,割り当てる
prorogation	(英国議会の)閉会,停会
prorogue	〈議会〉を停会にする
prosaic	散文の,散文体の
prosaically	単調に,平凡に;散文的に
proscenium	(舞台の)額縁;舞台前部(客席と舞台の間の部分)
proscribe	(特に法律で)…を禁ずる,差し止める / 《古》〈人〉から法律の保護を奪う;追放する
proscription	禁止 / 法律の保護(人権)のはく奪
prose	『散文』,散文体 / 散文の
prose poem	散文詩
prosecutable	起訴(告訴)される[べき]
prosecute	(…の罪で)〈人〉を『起訴する』,告訴する《+『名』〈人〉+『for』+『名』(do『ing』)》 / (司法手続きに訴えて)〈権利など〉を要求する / (特に最後まで)〈調査・研究・事業など〉をやり通す,遂行する / 起訴する
prosecution	〈U〉〈C〉『起訴』,告訴 / 《the~》《集合的に》起訴者側,検察当局 / 〈U〉(…の)実行,遂行《+『of』+『名』》
prosecutor	検察官 / 訴追者
