knight	『騎士』,ナイト,(中世の)武士 / 『ナイト爵』(しゃく),勲爵(くんしゃく)士(英国で国家に功労のあった者に与えられる尊称で,姓名の前にSirを付けて呼ばれ,baronetの次に位する;呼ぶ時はSir+名またはSir+名+姓でSir+姓のみで用いない.この位は当人一代限り) / チェスのこまの名 / …にナイト爵を授ける
knight-errant	(中世の,冒険を求めて遍歴した)武者修業者
knighthood	〈U〉騎士道 / 〈U〉〈C〉ナイトの位 / 《the ~》《集合的に》勲爵(くんしゃく)士
knightly	騎士の;騎士らしい;武勇の
knish	クニシュ(肉・じゃがいもなどの詰め物を入れて油であげたユダヤ料理)
knit	〈織物・服など〉を『編む』 / …をしっかりと組み合わせる《+『名』+『together,』+『together』+『名』》 / 〈まゆ〉を寄せる,しかめる / 『編物をする』 / しっかりと組み合わさる / メリヤス生地;〈C〉編んで作った衣類,メリヤス衣類
knitted	編んだ / メリヤスの
knitter	編む人 / 編み機
knitting	編むこと / 編み物,編みかけのもの
knitting machine	編み機
knitting needle	編み針,編み棒
knitwear	ニットウエア(毛糸で編んだ衣料)
knives	knife の複数形
knob	(幹などの)『節』,こぶ / (戸・引き出しなどの)『取っ手』,つまみ,握り / 小高い丘;(バター・石炭などの)丸い小さな塊 / ふし, こぶ; (ドアの)握り, 取っ手; (テレビなどの)つまみ; 小さな[丸い]塊; 円丘 / 金持ち,名士,上流人
knobbly	=knobby
knobby	節くれだった,でこぼこの
knobkerrie	投げ棒(先端にこぶのついたこん棒;南アフリカ黒人の武器)
knock	(音がするくらい強く)…を『たたく』,『打つ』,なぐる / (…に)〈体・体の一部〉を『ぶつける』《+『名』+『against』(『on』)+『名』》 / 《副詞[句]を伴って》…を打って(ある状態などに)する / 〈穴など〉を打ってあける / 《俗》…をけなす,こきおろす / 《英俗》…をびっくりさせる,にショックを与える / (…を)コツコツとたたく《+『on』(『at』)+『名』》 / (…に)ぶつかる,衝突する《+『against』(『into』)+『名』》 / (故障などで)〈エンジンなどが〉ガタガタいう,ノッキングを起こす / (…を)『打つこと』,(…に対する)一打(撃)《+『on』+『名』》 / (…を)ノックすること(音)《+『on』(『at』)+『名』》 / (エンジンの)ノック,ノッキング / 《話》不運;悪評
knock up	妊娠させる・はらませる / 打ち上げる、突き上げる、払い上げる / ドアをたたいて(寝ている人を)起こす、戸別訪問をする / ボールを乱打する、練習の打ち合いをする / 痛めつける、攻撃する、疲れさせる、くたくたに疲れる、ヘトヘトにする、ヘトヘトになる、病気になる / 大急ぎで作る、雑に作る、間に合わせに組み立てる / 得点する、点を稼ぐ、～の票を獲得しようとする / 傷つける、損害を与える、痛める、ぶっ壊す / 衝突する、薬を注射する
knock-knee	〈U〉(足の)わん曲 / 《複数形で》X脚,内わに足
knock-kneed	内またの
knock-on	(ラグビーで)ノックオン(受けそこなったボールを自分の前方に落とす反則)
knockabout	一種の小型ヨット / (着物など)荒仕事用の,じょうぶな / (劇などが)騒々しい,どたばたの
knockdown	打ち倒すような,圧倒的な / (値段が)底をついた / 取り壊せる;折り畳み式の / (ボクシングの)ノックダウン
knocker	ノックする人 / (また『doorknocker』)(玄関の)ノッカー,たたき金
knockers	(女性の)乳房,胸
knockout	(ボクシングの)ノックアウト(《略》『KO,K.O.,k.o.』) / 《話》すばらしい人(物) / ノックアウトする
knockup	(テニスで)試合前の打ち合い練習
knoll	(通例丸い)小さい丘;塚(mound)
knot	『結び目』,結び / (リボンなどで作った)飾り結び / (人・物の,通例小さな)群れ,一団 / (板・木材の)節,節目;(筋肉などの)隆起 / 困難(difficulty) / 縁,絆(きずな) / ノット(1時間に1海里(約1,852m)進む速さの単位) / …を『結びなわせる』《+『名』+『together』,+『together』+『名』》 / …に結び目をつける,を結ぶ / (こぶになって)堅く結ばれる,もつれる
knothole	節穴(ふしあな)
knotted	結び目のある,結ばれた / 節(ふし)のある
knotty	(木などが)節(こぶ)の多い / 紛糾した(puzzling),困難な
knout	革むち(昔のロシアの刑具)
know	(事実として,また知識の上で)…を『知る』,知っている;…を覚えている / …を『見て分かる』,識別できる,の見分けがつく;(…から)…を見て分かる《+『名』+『from』+『名』》 / (経験として)…を『知る』 / 『知る』,知っている,分かっている / 熟知
know-all	何でも知ったかぶりをする人, = know-it-all
know-how	(物事のやり方に関する具体的な)知識,仕事のこつ;技術情報
know-it-all	=know-all
know-nothing	何も知らない人,無学な人
knowable	知ることができる,認識できる,知りやすい
knowing	知ったかぶりの,物知り顔の / 抜けめのない(smart) / 知っている;(…を)知っている,(…に)精通した《+『about』+『名』》
knowingly	知りながら,わざと / 知ったかぶりをして,巧者らしく
knowledge	《時にa ~》『知識』,精通,認識,理解 / (…を)知っていること《+『that 節』》
knowledgeable	博識の,物知りの / 策にたけた
knowledgeably	博識に,うんちくを傾けて
known	knowの過去分詞 / 『名高い』,知られた
knuckle	指のつけ根の関節 / (四つ足獣の)ひざ肉 / …をげんこで打つ,指の関節ではじく / いっしょうけんめいにやる《+down》;(…に)精を出す《+『down to』+『名』》 / (…に)屈服する《+『under』+『名』》
knucklebone	指関節の骨
koala	コアラ,フクログマ(小犬ぐらいの有袋類の動物で,ユーカリの樹上に住む;オーストラリア産)
kobold	(ドイツ民間伝承の)小鬼,小妖精(goblin)
kohlrabi	カブラタマナ;キャベツの一種
kola	=cola
kola nut	コーラナッツ(コーラの木の実;カフェインを含み,清涼飲料の原料)
kolinsky	チョウセンイタチ[の毛皮]
kook	変人,とんま
kookaburra	ワライカワセミ(オーストラリア産の鳥;人の笑い声に似た鳴き声を出す)
kopeck,kopek	コペック(ロシアの貨幣単位;1/100ルーブル)
kopje,koppie	(南アフリカの)小丘,小山
koruna	コルーナ(チェコスロバキアの貨幣単位);コルーナ貨
kosher	(食物,特に肉がユダヤ人のおきてに従って)適法な,清浄な / 《話》純粋の,真正の,適正の / 清浄な食物
kotow	=kowtow
kowtow	叩頭(こうとう)(昔の中国の礼;ひれ伏して額を地面につける) / (…に)叩頭の礼をする《+『to』+『名』》 / (…に)ぺこぺこする《+『to』+『名』》
kraal	(垣を巡らした)南アフリカ原住民の村 / (南アフリカで,牛・羊などを飼うために)囲ってある場所
kraut	=sauerkraut・(軽蔑して)ドイツ人
kris	クリース(刃身が波形の短剣でマレー人などが武器として用いる)
krishna	クリシュナ神(ヒンズー教の神;Vishnu神の化身)
krona	(複‐nor)クローナ(スウェーデンの貨幣単位) / (複‐nur)クローナ(アイスランドの貨幣単位)
krone	クローネ(デンマーク・ノルウェーの貨幣単位)
krypton	クリプトン(希ガス元素;高性能電球の製造用;化学記号『Kr』)
kt.	karat
kuchen	クーヘン(フルーツ入りのドイツ風のコーヒーケーキ)
kudos	栄光;名声
kudzu	クズ(葛)(マメ科の多年草・牛馬の飼料)
kulak	ロシア革命以前の富裕な農民・商人
kummel	キュンメル酒(北ドイツ産の強い酒)
kumquat	キンカン[の実]
kung-fu	古代中国の護身術としての拳法(けんぽう)
kurus	クルシュ(トルコ貨幣;liraの1/100)
kvass	クワス(東欧・ロシア産のライ麦ビール)
kw,KW	kilowatt
kwacha	クワーチャー(ザンビアの貨幣単位)
kwela	クェイラ(南アフリカ黒人の踊りの音楽)
kwh[r],KWh,K.W.H.	kilowatt-hour
kyrie eleison	〈U〉キリスト教の礼拝文句の一部(カトリックや正教会、聖公会などの典礼で使われる)キリエ・エレイソン(ギリシャ語で「主よ、憐れみたまえ」の意味)
