N	nitrogenの化学記号
N,N.	North; Northern
N,n	英語アルファベットの第14字(子音字) / N字型のもの / 《n》不定整数
N-bomb	核爆弾
N.A.	North America / not applicable(不適格) / not available(該当なし)
N.B.,n.b.	ラテン語
N.C.,NC	North Carolina
N.D.,ND	North Dakota
N.Dak.	North Dakota
N.E.	New England / North-East[ern]
N.G.	National Guard(米国)州民軍,州兵 / (また『n.g.』)no good
N.H.,NH	New Hampshire
N.J.,NJ	New Jersey
N.M.,NM,N.Mex.	New Mexico
N.S.	Nova Scotia / New Style
N.T.P.	normal temperature and pressure 平常体温ならびに血圧
N.Y.,NY	New York
N.Y.C.	New York City
N.Z.	New Zealand
NAACP	National Association for the Advancement of Colored People全米有色人種地位向上協会
NAS	National Academy of Sciences(米国)連邦学術会議
NASA	The National Aeronautics and Space Administration 米国航空宇宙局
NATO	North Atlantic Treaty Organization
NB	Nebraska
NBS	National Bureau of Standards(米国)規格基準局
NCO	Noncommissioned Officer陸軍下士官
NE	Nebraska / northeast[ern]
NE,N.E.	northeast; northeastern
NEA	National Education Association(米国)連邦教育委員会
NEB	New English Bible新英訳聖書
NET	National Educational Television 米教育テレビジョン
NF,N.F.	no funds預金なし(銀行から小切払出入への通知) / Norman French
NGK.,N.GK.	New Greek
NHI	National Health Insurance(英国の)国民健康保険
NHS	National Health Service
NL	New Latin
NNE	north-northeast
NNW	north-northwest
NORAD	North American Air Defense Command北米大陸防空総軍司令部
NRA	National Recovery Administration 米国産業復興局
NRC	Nuclear Regulatory Commission 米国原子力規制委員会
NS	Nuclear ship 原子力船
NSA	National Security Agency(米国の)国家安全保障局
NSC	National Security Council(米国の)国家安全保障会議
NSF	National Science Foundation 全米科学財団 / not sufficient funds(銀行の)預金不足
NT,N.T.	New Testament 新約聖書
NV	Nevada
NW,N.W.,n.w.	northwest / northwestern
Na	sodium(ラテン語natrium)の化学記号
Nairobi	ナイロビ(ケニア)Kenya共和国の首都
Nanking	ナンキン(南京)(揚子江に臨む港市て,もと中国の首都)
Naples	ナポリ(イタリア南西部の港市;イタリア名はNapoli)
Napoleonic	ナポレオン1世の;ナポレオン時代の / ナポレオンのような
Napoléon	ナポレオン1世(~『Bonaparte』;1769‐1821;コルシカ生まれのフランスの皇帝) / ナポレオン3世(『Louis ~ Bonaparte』;1808‐73;ナポレオン1世の甥(おい)で、フランス皇帝)
Narcissus	ナルシサス(ギリシア神話で水に映った自分の姿に恋して水に落ちスイセンの花と化した美女年)
Nashville	ナッシュビル(米国Tennessee州中部の都市で州都)
National Guard	《the~;集合的に》(米国の)州民軍,州兵(平時は州の治安維持にあたり,戦時には,正規軍に編入される民兵隊)
National Health Service	(英国の)国民健康保険制度
National Insurance	(英国の)国民保険[制度]
National League	《the~》ナショナルリーグ(米国2大プロ野球連盟の一つ)
National Socialism	=Nazism,Naziism
National Trust	(英国の)史(名)跡保存協会
Navaho	〈C〉ナバホ族(人)(北米New Mexico, Arizonaに住むインディアン = Navajo) / 〈U〉ナバホ語
Nazarene	〈C〉ナザレの人 / 《the Nazarene》キリスト
Nazareth	ナザレ(イスラエル北部の都市;キリストが少年時代を過ごして)
Nazi	〈C〉(ドイツの)ナチ党員;《the Nazis》ナチ党(Hitlerが創設したドイツの国家社会主義政党) / ナチ党の
Nazism,Naziism	ナチズム,ドイツ国家社会主義
Nb	niobiumの化学記号
Nd	neodymiumの化学記号
Ne	neonの化学記号
Neanderthal man	〈U〉ネアンデルタール人(旧石器時代の原始人類) / 〈C〉《話》(がん強だが)鈍い男
Neapolitan	ナポリの,ナポリ風の / ナポリ[生まれの]人,ナポリの住人
Near East	《the~》近東
Neb.,Nebr.	Nebraska
Nebraska	ネブラスカ州(米国中部の州;州都はLincoln;《略》『Neb.,Nebr.,NB』)
Negress	黒人女性
Negritude	(特にアフリカの)黒人文化,黒人としての誇り
Negro	黒人,ニグロ / 黒人の,ニグロの;黒人に関する
Negroid	黒人に似た;黒人系の / 黒人系の人
Nehru	ネール(『Jawaharlal~』;1889‐1964;インド共和国の初代首相1947‐64)
Nemesis	ネメシス(ギリシア神話で人に応報天罰を与える女神) / 《n-》《文》〈U〉天罰,因果;〈C〉天罰(因果)を与える人;かなわない相手
Neolithic	新石器時代の
Nepal	ネパール(インドとチベットの間にある国。2008年に王制を廃止;首都はKatmandu)
Neptune	ネプチューン(ローマ神話の海神で,ギリシア神話のPoseidonにあたる) / 海王星
Nereid	ネレイス(ギリシア神話の海の精)
Nero	ネロ(キリスト教徒を迫害した残虐なローマ皇帝)
Nestor	《単数形で》《文》賢明な老人,長老
Neth.	Netherlands
Netherlander	オランダ人
Netherlands	『オランダ』(Hollandの公式名;首都はAmsterdam,政府所在地はThe Hague)
Nev.	Nevada
Nevada	ネバダ州(米国西部の州;州都はCarson City;《略》『Nev.,NV』)
New Deal	ニューディール政策(米国大統領F.D.Rooseveltが1933年にとった経済復興と社会保障増進の政策)
New Delhi	ニューデリー(インド北部都市;インド共和国の首都)
New England	ニューイングランド(Connecticut,Massachusetts,Rhode Island,Vermont,New Hampshire,Maineの米国北東部6州)
New Englander	ニューイングランド地方の人(住民)
New Guinea	ニューギニア(オーストラリア大陸の北方にある世界第2の大島)
New Hampshire	ニューハンプシャー(米国北東部の州;州都はConcord;《略》N.H.,NH)
New Haven	ニューヘーブン(米国Connecticut州南部のLong Island Soundに臨む港市;Yale大学の所在地)
New Jersey	ニュージャージー州(米国東部大西男岸の州;州都はTrenton;《略》N.J.,NJ)
New Left	新左翼(1960年代,英国・米国などで体制変革論をかかげた若者のグループ)
New Mexico	ニューメキシコ州(米国南西部の州;州都はSanta Fe;《略》N.M.,NM,N,Mex.)
New Orleans	ニューオーリンズ(米国のLouisiana州のミシシッピ河口に近い港市;綿の大集散地)
New Testament	《the ~》新約聖書(《略》『NT.,N.T.』)
New World	新世界(西半球,つまり南北米大陸を言う)
New Year	=New Year's Day / 〈C〉『正月』 / 《the n- y-》新年,来たるべき年
New Year's Day	元日
New Year's Eve	大みそか
New York	『ニューヨーク州』(米国北部東海岸の州;州都はAlbany;《略》『N.Y.,NY』) / (また『New York City』)『ニューヨーク市』(米国New York州南東端ハドソン河口の港市;《略》『N.Y.C』)
New Yorker	ニューヨーク市民,ニューヨーク州の住民
New Zealand	『ニュージーランド』(オーストラリア南東方の英国自治領;南北両島から成る;首都Wellington;《略》『N.Z.』)
New-Year	《名詞の前にのみ用いて》新年の,元日の
Newcastle	ニューカッスル(イングランド北部東海岸の貿易港;造船・製鉄の中心地;アメリカの同名の都市はNew Castleとつづる)
Newf.	Newfoundland
Newfoundland	ニューファンドランド島(カナダ東部の大きな島;カナダ領) / 〈C〉ニューファンドランド犬(Newfoundland原産;水泳の巧みなスパニエル種の大型犬) / ニューファンドランド 《カナダ東端の島または同島および Labrador 地方を含む州;略 N.F., NFD, Nfd., Nfld., Newf.》
Newton	ニュートン(『Sir Isaac ~』;1642‐1727;英国の物理学者)
Newtonian	ニュートン学説信奉者
Nfld,Nfd.	Newfoundland
Ni	nickelの化学記号
Niagara Falls	ナイアガラの滝(米国とカナダの国境を流れ,Niagara川にかかる大滝)
Nicaragua	ニカラグア(中米の共和国;首都はManagua)
Nice	ニース(フランス南東部の地中海に臨む港市;避寒・保養地)
Nicholas	聖ニコラス(『Saint』(『St.』)~; 4世紀の小アジアの司教;子供・旅人・水夫,およびロシアの守護聖人;Santa Clausの名は彼に由来)
Nielsen rating	ニールセン視聴率(モニターによるテレビ番組の視聴率)
Nietzsche	ニーチェ(『Friedrich Wilhelm』~;1844‐1900;ドイツの哲学者)
Niger	ニジェール(アフリカ北西部の共和国;首都はNiamey)
Nigeria	ナイジェリア(アフリカ西部の共和国で英連邦の一員;首都はLagos)
Nightingale	ナイチンゲール(『Florence』『~』;1820‐1910;近代看護法と看護婦養成に貢献した英国婦人)
Nike	ニケ(ギリシア神話の勝利の女神) / 〈C〉ナイキ(米軍の対空誘導弾) ・ ナイキ (米国のスポーツ用品製造会社)
Nile	ナイル川(アフリカ東部ビクトリア湖に発し地中海に注ぐ大河)
Nilotic	ナイル川の / ナイル川流域住宅の / ナイル言語群の
Nimrod	ニムロデ(聖書に出てくる狩りの名人) / 〈C〉《しばしばn-》(一般に)狩りの名人
Nippon	日本
Nipponese	=Japanese
Nisei	二世(米国在住日本人の2代目)
Nissen hut	かまぼこ型組立兵舎,英国の技師 Peter Nissenの名前に由来する
Nixon	ニクソン(『Richard Milhous~』;1913‐;米国第37代大統領1969‐74)
No	nobeliumの化学記号
No.,no.	〈C〉《数字の前に用い,冠詞をつけず》『…番』,第…号,…番地・north; northern
Noah	ノア(ユダヤの信仰厚い家長;大洪水(the Flood)のとき,神の命により箱舟(ark)を作り,家族とすべての動物一つがいずつを入れて難を逃れた:旧約聖書「創世記」)
Noah's ark	ノアの箱舟
Nobel Prize	ノーベル賞
Nobelist	ノーベル賞受賞者
Noel,Noël	〈U〉クリスマス / 〈C〉《n-》クリスマス祝歌(Christmas carol)
Nor.	North / Norman / Norway; Norwegian
Nordic	北欧人の(特にスカンジナビアのゲルマン人種をいう)
Norman	〈C〉ノルマン人;《the Normans》ノルマン民族 / 10世紀にノルマンジーを征服した古代スカンジナビア / 1066年,英国を征服したフランス人と古代スカンジナビア人の混血の子孫 / (フランス北部ノルマンジー地方に住む人) / =Norman French / ノルマンジーの;ノルマン民族の / (建築が)ノルマン式の
Norman Conquest	(また『the Conquest』)ノルマン人の英国征服(1066年ノルマンジー公William the Conquerorによる英国征服)
Norman French	ノルマン・フランス語(ノルマンの英国征服後15世紀まで英国の公用語として使われた)
Normandy	ノルマンジー(フランス北部の英国海峡に面した地方)
Norse	古代スカンジナビアの;古代スカンジナビア人(語)の / =Norwegian / 《the~》《集合的に;複数扱い》(特に古代の)ノルウェー人;古代スカンジナビア人 / =Norwegian
Norseman	=Northman
North Africa	北アフリカ(サハラ砂漠以北)
North America	北アメリカ(合衆国・カナダ・メキシコを含む大陸)
North American	北米の / 北米人
North Carolina	ノースカロライナ州(米国南東部大西洋岸の州;州都はRaleigh;《略》『N.C.,NC』)
North Dakota	ノースダコタ州(米国北中部の州;都はBismarck;《略》『N.D.,ND,N.Dak.』)
North Korea	北朝鮮(公式名the Democratic People's Republic of Korea(朝鮮民主主義人民共和国);首都は平壌Pyongyang)
North Pole	北極
North Sea	北海(イギリス・オランダ・デンマーク・ノルウェーに囲まれた海)
North Star	北極星(Polaris)
Northern Hemisphere	北半球
Northern Ireland	北アイルランド(アイルランドの北部の自治地方で英本国の一部;《略》『N.I』)
Northman	古代スカンジナビア人(特に8‐11世紀にフランス北部および英国に侵入した海賊)
Northwest Territory	《the~》(もと)北西部属領地域(現在はIllinois,Indiana,Michigan,Ohio,Wisconsin,およびMinnesota州の一部に分けられている) / 《複数形で》(北カナダの)北西地区
Norw.	Norway / Norwegian
Norway	ノルウェー(スカンジナビア半島の西半分を占める王国;首都はOslo)
Norwegian	ノルウェーの / 〈C〉ノルウェー人 / 〈U〉ノルウェー語
Nos.,nos.	Numbers
Notation	〈C〉(特殊な記号・符号による一組の)表記,表習 / 〈U〉(特殊な記号・符号による)表記法 / 〈C〉《米》(本の欄外などの)書き込み,注記(note)
Notre Dame	(パリにある)ノートルダム寺院 / 聖母マリア
Nov.	November
Nova Scotia	ノウァスコシア(カンダ南東部の半島,またその州)
November	11月(《略》Nov.)
Novocaine	ノボカイン(特に歯科治療などの局所麻酔剤の商標名)
Np	neptuniumの化学記号
Number Ten	No.10 Downing Streetダウニング街10番地(英国首相官邸所在地で政府中枢部)
Numbers	民数記(旧約聖書の第四書)
Nv.	Nevada
n.	noun / north; northern / noon / number / note / name / neuter
n.d.	no date日付なし
n.e.s.,N.E.S.	not elsewhere specified 特に別記なき場合は
n.p.	no pagination ページを付けずに・no place of publication 発行地名を付けずに・(また『N.P』)no protest(手形で)拒絶証書不要
n.s.	not specified 明記されずに
n.u.	name unknown 氏名不詳
n/a	no account取引きなし
nab	(現行犯で)…'を'逮捕する / …'を'ひっつかむ,ひったくる
nabob	(18‐19世紀のイギリスで,アジアでもうけた)大金持ち;《軽べつして》大尽;お偉がた
nacelle	(飛行機の)機関室,乗務員室
nacre	=mother-of-pearl
nadir	〈U〉《the~》天底(天体の1点から鉛直に下ろした地上の点) / 〈C〉《単数形で》最下点;どん底
nae	=no, not / =no
nag	おいぼれ馬;駄馬(だば) / 《話》(一般に)馬,(特に)競走馬 / (…のことで)〈人〉'に'がみがみ言う,口やかましく言う《+『名』+『about』+『名』(do『ing』)》;(…をせがんで)…'に'うるさく言う《+『名』+『for』+『名』》;…'に'うるさく言って(…)させる《+『名』+『into』+『名』(do『ing』)》 / 〈物事が〉…'を'しつこく悩ませる / (…に)がみがみ言って苦しめる《+『at』+『名』》 / 〈物事が〉悩みの種になる
naiad	(ギリシア神話・ローマ神話で,少女の姿をして川や泉に住む)水の精
naif,naïf	=naive
nail	(手の)『つめ』(fingernail);《まれ》(足の)つめ(toe-nail);(鳥獣の)つめ(claw, talon) / 『くぎ』,びょう / (…に)…'を'くぎ(びょう)で止める《+『名』+『on』(『to』)+『名』》 / (…に)〈人,人の注意・目など〉'を'くぎ付けにする《+『名』+『on』(『to』)+名》 / 《話》…'を'つかまえる,しとめる;〈うそなど〉'を'見破る
nail file	(つめの手入れ用の)つめやすり
nail polish	マニキュア液(《英》nail varnish)
nail scissors	つめ切りばさみ
nailbrush	(マニキュア用の)つめのブラシ
nainsook	ネインスック(肌着・幼児服用の柔らかな綿織物)
naive,naïve	(若き・経験不足から)〈人・言葉などが〉無邪気な,天真らんまんな,世間知らずな / 人を信じやすい,だまされやすい 日本語で「繊細な」という意味で「ナイーブ」使われることがありますが、英語では「ナイーブ」にそのようなニュアンスは含まれません。
naivety,naïvety	=naiveté
naiveté,naïveté,naivete	〈U〉天真らんまん,純真;〈C〉《複数形で》無邪気な言葉(行為)
naked	(体の全部,または一部が)『裸の』 / 『はぎ取られた』,むき出しにされた / (目が)肉眼の,裸眼の / 《名詞の前にのみ用いて》(事が)赤裸裸の,あからさまの
namby-pamby	《話》めそめそした;にやけた / 感傷的な話(詩文);めめしい人,にやけた男
name	『名』,『名前』,姓名;(物の)名称;名義 / 《単数形で》『名声』;評判(reputation) / 悪口,悪態 / 《俗》有名な人 / 名のある,有名な,一流銘柄の / …'に'『名をつける』,命名する / 'を'『名を言う』 / 〈人〉'を'指名する,任命する / (…に対して)…'を'指定する《+『名』+『for』+『名』》
name day	《古》聖名祝日(人が名をもらった聖人の祝日) / 命名日,洗礼日
name of the game	《話》(行動などの)ねらい,決め手,一番肝心なこと,最重要点,主目的,本質,核心,要点,
namedrop	《話》(よく知らないくせに)有名人の名前や作品を口にする
nameless	名前のついていない / 名の知られていない,無名の / 口に出すのもはばかられる / 口に出して説明できない
namely	『すなわち』,つまり(that is to say)
nameplate	表札,名札
namesake	同名の人 / (ある人の)名をもらった人
nankeen,nankin	〈U〉南京(なんきん)もめん / 《複数形で》もめんのズボン
nanny	《英》(特に上流家庭の)乳母(うば),ばあや
nanny goat	雌ヤギ
nanosecond	10億分の1秒
nap	(特に日中の)『ひと眠り』,昼寝 / ひと眼りする,まどろむ / (ラシャなどの)けば / ナポレオン(カードゲームの一種) / 〈新聞記者などが〉〈勝ち馬の名〉'を'予想する
napalm	ナパーム(焼い弾・火炎放射器に用いる高い放火性をもつゼリー状の物質)
nape	うなじ,えり首
napery	食卓用白布(テーブル・クロス・ナプキンなど)
naphtha	ナフサ,粗製ガソリン
naphthalene,naphthaline	ナフタリン
napkin	(また『table』『napkin』)『ナプキン』 / 《英》=diaper
napkin ring	ナプキンリング(各人のナプキンを巻いてはさんでおく木(銀)製などの輪)
nappy	=diaper
narc	麻薬取締官
narcissi	narcissusの複数
narcissism	自己陶酔症,ナルシシズム
narcissist	自己陶酔者
narcissistic	自己陶酔の,自己に酔った
narcissus	スイセン
narcosis	(麻酔剤による)昏睡(こんすい)状態
narcotic	麻酔性の / 《名詞の前にのみ用いて》麻薬の / 麻酔剤,麻薬
narcotism	麻薬中毒;(麻酔による)昏睡(こんすい)
narcotize,narcotise	…'に'麻酔をかける;…'を'鈍くさせる
nard	甘松(かんしょう)香(古代人が用いた香油)
nares	鼻孔(びこう),単数形は「nare」
nark	=narc / たれ込み屋 / …'を'怒らせる,悩ませる・不平を言う
narky	ふきげんな
narrate	…'の'話をする,'を'物語る,述べる / (ドラマなどで)語り手になる
narration	〈U〉(…について)『話をすること』,物語ること《+『of』+『名』》 / 〈C〉〈U〉物語(narrative) / 〈U〉(文法上の)話法
narrative	〈C〉〈U〉『物語』,話(story) / 〈U〉話術,語り口 / 『物語の』 / 手術の
narrator,narrater	『語り手』,ナレーター
narrow	(幅の)『狭い』,細い / 『範囲(種類)が限られた』(limited) / 『厳密な』,正確な(exact) / 『やっとり』,かろうじての / (海・川などの)『せばまった場所』; / (…に)…'を'狭くする,細める,せばめる《+『down』+『名』(+『名』+『down』)+『to』+『名』》 / 狭くする,細くなる
narrow boat	運河用ボート
narrow-gauge	(鉄道の)狭軌レール
narrow-minded	(人が)心の狭い,偏狭な,(意見などが)偏った
narrowly	狭く,細く;限定して / かろうじて,危うく,やっと / 綿密に,つぶさに
narrowness	(幅が)狭いこと / (範囲などが)限られていること
narthex	拝廊(教会の正面入口から本堂の至る広間になっている廊下)
narwhal	イッカク(寒帯の海に住む鯨の一種で,雄には角のような長いきばが一本ある)
nasal	《名詞の前にのみ用いて》鼻の / 鼻声の / (音声が)鼻音の / (音声で)鼻音;鼻音字([m][n][g])
nasalization, nasalisation	鼻音化
nasalize,nasalise	…'を'鼻声で発音する,鼻音化する / 鼻声で言う
nascent	始まりの,初期の
nastily	不快に / 意地悪く / みだらに
nastiness	不快さ / 意地悪さ / みだらさ
nasturtium	キンレンカ(黄や赤の花をつける園芸植物)
nasty	『意地悪な』,卑劣な / 『不快な』,いやな(unpleasant) / みだらな,下品な / 厄介な,ひどい
nat.	national / natural
natal	《おもに文》誕生の
natality	出生率
nates	《複数形》しり,臀部(でんぶ)
nation	《集合的に》『国民』(people) / 『国家』,国(country) / 民族,種族(北米インディアンの)部族
nation-state	民族国家
national	『国民の』;『国家の』 / 『国立の』,国有の / 全国的な / 《修飾語を伴って》(特定国の)市民,国民
national anthem	国歌
national debt	〈C〉国債 / 国の借金 / 政府債務
national government	連立内閣,挙国一致内閣
national monument	国定の史(名)跡,国定天然記念物
national service	《しばしば『N-』『S-』》(英国の)国民兵役[期間](《米》draft, selective service)
nationalism	愛国心;国家主義 / (植民地などの)民族主義,独立自治主義
nationalist	国家(国粋)主義者 / 民族独立主義者 / 国家(国粋)主義の;民族独立主義の
nationalistic	=nationalist
nationalistically	国家(国粋)主義的に;民族独立主義[者]的に
nationality	〈U〉国籍 / 〈C〉民族 / 〈U〉国家としての独立
nationalization,nationalisation	(…の)国民化《+『of』+『名』》 / (…の)国有化,国営化《+『of』+『名』》
nationalize, nationalise	〈土地・産業など〉'を'国有化する / …'を'全国的にする,国家的にする
nationally	国家的に,国家的見地から / 国全的に
nationwide	全国的な
native	《名詞の前にのみ用いて》『出生地の』,母国の / 『生まれつきの』,生来の / 原産の,土地特有の / 《名詞の前にのみ用いて》土着の;《今はまれ》原住民の,原住民特有の / 天然のままの;純粋な / (…)『生まれの人』《+『of』+『名』》 / (移民・旅行者などと区別して)土着の人;《今はまれ》原住民 / (…に)固有の動物(植物);(…の)原産物《+『of』+『名』》
nativism	原住民保護主義(政策)
nativity	〈U〉〈C〉出生(birth) / 《the N-》キリストの降誕;キリスト降誕の図;キリスト降誕祭,クリスマス(Christmas)
nativity play	キリストの降誕劇
natl	national
natter	(…について)おしゃべりする《+『away on』(『about』)+『名』》 / たわいないおしゃべり,むだ話,不平を言う
nattily	こぎれいに,きちんとして
nattiness	きちんとしていること
natty	(服装・風さいなど)こぎれいな,きちんとした
natural	『自然のままの』,自然にある,自然が作る / 自然に関する / 『当然の』,あたりまえの / 『生まれつきの』(inborn) / 生き写しの,真に迫った / 気どらない,飾らない / (音階が)本位の / (音階の)本位音;本位記号 / 《単数形で》《話》(…の)生来の達人,(…に)最初からうってつけの人《+『for』(『as』)+『名』》
natural gas	天然ガス
natural history	博物学(動物学・植物学・鉱物学など自然物の研究を扱う)
natural law	(道徳上の)自然法;自然の理法,自然法則
natural number	自然数(1から始まって無限に続く正の整数)
natural philosophy	《古》自然科学,(特に)物理学
natural resources	《複数形》天然資源
natural science	自然科学
natural selection	(ダーウィンの進化論でいう)自然選択,自然淘汰
naturalism	(文学・芸術・哲学などの)自然主義
naturalist	博物学者;(特に)動物(植物)学者 / (文学・芸術・哲学などの)自然主義者 / =naturalistic
naturalistic	(文学・芸術・哲学などの)自然主義的な,写実的な
naturalization	帰化 / (文芸などの)移入 / (動物植などの)移植
naturalize,naturalise	(…に)〈外国人〉'を'帰化させる《+『名』+『in』(『into』)+『名』》,(…として)…に市民権を与える《+『名』+『as』+『名』》 / (…に)〈動植物〉'を'移植する,帰化させる《+『名』+『in』(『into』)+『名』》 / (…に)〈外国の言葉・習慣など〉'を'取り入る《+『名』+『in』(『into』)+『名』》
naturally	『気どらずに』,自然に / 《しばしば文全体を修飾して》『当然』,もちろん(of course) / 『生まれつき』(by nature) / 自然の力で,ひとりでに
nature	〈U〉『自然』,自然界,万物;自然の力;《しばしば『N-』》(擬人化した)自然,自然の女神 / 〈C〉〈U〉(人・動物,あるいは物事の持っている)『本質』,性質,本性 / 〈C〉《単数形で》種類(sort, kind)
naturism	自然崇拝説 / 裸体主義
naturopathy	自然療法医,食餌(しょくじ)療法医
naught	〈U〉《古》《詩》無,無価値(nothing) / 《英》(またnought)〈C〉〈U〉ゼロ,零
naughtily	わんぱくに
naughtiness	わんぱく
naughty	(子供が)『いたずらな』 / 《遠回しに》みだらな,わいせつな
nausea	吐き気 / 強い嫌悪(けんお)(loathing)
nauseate	…'に'吐き気を起こさせる / …'に'ひどくいやな感じを与える
nauseous	 {形}吐き気を催すような / 吐き気がする / (比喩的)不快な,むかむかする
naut.	nautical
nautch	ノーチ(インドの踊り子の演じるショーダンス)
nautical	船の;船員の;航海の
nautical mile	海里(1,852メートル)
nautilus	オウムガイ(南太平洋・インド洋産の渦巻き貝)
nav.	naval / navigable
naval	『海軍の』;軍艦の
nave	(教会の)身廊(しんろう),会衆席
navel	へそ / 中心(center)
navel orange	ネーブル(オレンジの一種)
navigability	(川・海などの)航行可能(性)
navigable	(川・海などが)船が通える,航行可能な / (船・航空機が)航海(航空)に耐える
navigate	〈人が〉〈船・航空機など〉'を'『操縦する』 / 〈船・飛行機が〉…'を'『航行する』,〈人が〉…'を'船(飛行機)で行く / 〈物事〉'を'うまくやっていく / (飛行機)を操縦する,航行する
navigation	(船・飛行機の)『航行』 / 航海術,航空術
navigator	『航海士』,航空士 / 航海熟練者(特に初期の海洋深検家についていう)
navvy	土木労働者,土方,土工
navy	《集合的に;《米》単数扱い,《英》単数・複数扱い》『海軍』 / 《集合的に;《米》単数扱い,《英》単数・複数扱い》《通例the N-》(ある国の)海軍 / 〈U〉=navy blue
navy bean	白インゲンマメ(《英》haricot [bean])
navy exchange	(海軍基地の)酒保,売店
navy-blue	濃紺色(英国海軍の制服の色) / 濃紺[色]の
nay	《古》いな,いや(no) / 《文》そればかりでなく,それどころか / 拒絶,否定 / 反対投票;反対投票者
ne plus ultra	(…の)極致,頂点《+『of』+『名』》,極限
ne'er	=never
ne'er-do-well	ろくでなし,ごくつぶし / ろくでなしの
neap	小潮(こしお)(潮の干満の差が最小の日)
neap tide	=neap,最低潮,小潮
near	(空間的・時間的に)(…の)『近くに』,(…に)接近して《+『to』+『名』》 / 《しばしば複合語を作って》『ほとんど』(almost, nearly) / (空間的・時間的に)『近い』,接近した / (関係などが)『身近な』 / 『きわどい』,やっとの / (空間的・時間的に)…『に近く』,『の近くに』 / (状態などが)…に近く,…しそうで / (時間・空間上)…'に'近づく / 近づく,接近する / 「ほとんど…,ほぼ…」の意を表す
near beer	(アルコール分0.5%以下の)代用ビール
near miss	至近弾 / (航空機の)異常接近,ニアミス / 惜しい失敗,成功の一歩手前
near thing	《単数形で》《話》間一髪の危機
nearby	《名詞の前にのみ用いて》すぐ近くの,そばの(close by) / 《名詞・動詞の後に用いて》近くに / 《前置詞的に》…の近くの(に)
nearly	『ほとんど』,もう少しで / 《まれ》(血縁・利害・関連などについて)密接に,親密に(closely)
nearness	(…への)近さ,接近,近似《+『to』+『名』》
nearside	《名詞の前にのみ用いて》《おもに英》(馬や馬車の)左側の
nearsighted	《おもに米》近視[眼]の(《英》shortsighted)
neat	(見た目に)『きちんと整った』,小ぎれいな / (人などが)きれい好きな;(服装などが)さっぱりした / (やり方・話し方などが)手ぎわのよい / 《米話;現在はまれ》すばらしい,すてきな / 《話》(酒などが)水で割らない,ストレートの
neath,'neath	《詞》=beneath
neatly	きちんと,こぎれいに / 手ぎわよく,てきぱきと
neatness	きちんとしていること,整然 / 手ぎわのよいこと,器用
nebbish	《米俗》つまらぬ人,ろくでなし
nebula	星雲
nebular	星雲の;星雲状の
nebulize,nebulise	…'を'霧状にする
nebulosity	〈C〉星雲状の物 / 〈U〉ぼんやりした状態,あいまいさ
nebulous	曇っている / 漠然とした(vague)
necessarily	『必ず』,必然的に
necessary	(物事が)『必要な』,なくてはならない / 『必然的な』,避けられない
necessitate	〈物事が〉…'を'必要とする,余儀なくする(force, compel)
necessitous	貧しい / 《文》差し迫った
necessity	〈U〉《時にa ~》『必要』,必要性;必然,当然のこと・必要品〈C〉《しばしば複数形で》(…に)『どうしても必要なもの』,(…の)必需品《+『of』(『for, to』)+『名』》 / 〈U〉(貧乏・不幸などによる)困窮,窮乏
neck	〈C〉(人間・動物の)『首』;首の骨 / 〈C〉(衣服の)えり / 〈C〉首の形をした物 / 〈U〉〈C〉(食品としての)(羊などの)頚肉(けいにく) / キスして愛撫(あいぶ)し合う
neckband	(衣服についたひも・レースの)首飾り
neckerchief	首巻き,えり巻き,ネッカチーフ
necklace	『首飾り』,ネックレス
necklet	小さな首飾り / 毛のえり巻き
neckline	(洋装の)えりぐり
necktie	=tie
neckwear	ネックウェアー(えりもとに着ける服飾品;ネクタイ・スカーフなど)
necrology	(一定期間内の)死亡者名簿;死亡告示
necromancer	心霊術師,(降霊術を用いる)預言者
necromancy	交霊による占い / いかがわしい魔術
necrophilia	死体姦(かん)症(死体に性的魅力を感じること)
necrophiliac	死体姦(かん)症患者
necropolis	《文》(古代都市などの)大墓地
necrosis	壊疽(えそ)
nectar	ネクター(ギリシア神話で不老不死になるという神々の酒) / (一般に)甘美な飲み物,甘露 / (花の)みつ
nectarine	ネクタリン,ツバイモモ(モモの一種)
nee,née	旧姓は(既婚夫人の結婚前の姓を示すのに用いる)
need	〈U〉《時にa~》『必要』,入用 / 〈C〉《しばしば複数形で》『必要なもの』,(…の)必要品《+『for』+『名』》 / 〈C〉(…に対する)欲求,切望《+『for』+『名』》 / 〈U〉(…の)『困窮』,欠乏,不足《+『of』(『for』)+『名』》 / 〈U〉『困った時』(『事態』),まさかの時 / …'を'必要とする,要する / 《疑問文・否定文,また疑問・否定の内容を表す文で》…『する必要がある』,しなければならない / 《need not have doneの形で》…する必要はなかったのに
needful	《まれ》必要な,なくてはならない;(…に)必要な《+『for』+『名』》
needle	『針』,縫い針;(編物用の)かぎ針,編み棒 / (レコードプレーヤーの)針;(磁石・らしん盤など各種計器の)針 / 外科用の針(縫合針など);注射針 / 針状のもの;小尖塔(しょうせんとう);とがった山頂 / (マツ・モミなどの)針葉 / …'を'針で縫う(編む);…'に'針を通す / (…のことで)〈人〉‘をいじめる,悩ます《+『名』+『about』+『名』(do『ing』)》;〈人〉'を'いじめて(…)させる《『名』+『into』do『ing』》 / 縫い物(編物)をする
needlepoint	ニードルポイント(キャンバス地に折した毛糸の刺しゅう)
needless	『不必要な』
needlessly	用もないのに;いわれなく
needlewoman	お針子
needlework	針仕事
needn't	need notの短縮形
needs	《直ちに, 当面》 必要なもの[こと], 要求, 要望されるもの
needy	非常に暮らしに困っている / 《名詞的に;the~》《集合的に;複数扱い》貧困者たち
nefarious	不正の,ふらちな,邪悪な
neg.	negative
negate	…'を'無効にする,無意味にする / 〈存在・真実など〉'を'否定する(deny)
negation	否定,打ち消し / 無,非存在
negative	『否定の』,反対の / 『消極的な』,控えめの / 陰電気の;(数値が)負の,マイナスの(minus);(写真が)陰画の,ネガの;(医学検査結果が)陰性の / 『否定』,拒否,「いやだ」と言うこと / 否定語[句] / 《the~》(特に討論会の)反対者側,反対派 / (電気分解に用いる)陰極板 / (数値の)負数 / (写真の)陰画,ネガ / 《しばしば受動態に用いて》…'に'反対投票をする / =negate
negative income tax	(国庫から低所得者への)収入補助[制度]
negative pole	(磁石の)陰極
negatively	否定的に / 消極的に
negativism	否定論,懐疑論
neglect	…'を'『無視する』,かまわない,ほっておく / (特に不注意で)…'を'『怠る』,忘れる(disregard) / (…の)『無視』,怠慢,(…を)ほったらかしにすること《+『of』+『名』》 / 無視(放置)されていること(状態)
neglected	無視された,顧みられない
neglectful	怠慢な,ほったらかしの;(…を)投げやりにしている《+『of』+『名』》(careless)
negligee,négligé	化粧着,ネグリジェ
negligence	(習慣的な)『怠慢』,不注意,落ち度;(法律で)過失 / 『むとんじゃく』,だらしなさ
negligent	『怠慢な』,なげやりな / 『むとんじゃくな』,かまわない
negligible	取るに足らない
negotiable	交渉できる / (手形などが)譲渡できる / 《話》(障害・困難などが)乗り越えられる
negotiate	(人と)〈物事〉'を'『取り決める』,『協定する』《+『名』+『with』+『名』〈人〉》 / 〈小切手・手形・証券など〉'を'売却する,換金する / 《話》〈障害・困難〉'を'うまく乗り越える,切り抜ける / (人と物事について)取り決める,協定する《+『with』+『名』〈人〉+『about』(『for,on,over』)+『名』》
negotiation	〈U〉〈C〉《しばしば複数形で》(物事についての人との)『取り決め』,『交渉』,話し合い《+『with』(『between』)+『名』〈人〉+『about』(『for,on,over』)+『名』》 / 〈U〉(手形などの)換金,譲渡 / 〈U〉《話》(障害・困難などの)克服
negotiator	交渉者,協定者 / (小切手などの)譲渡者
negus	ニーガス酒(ワイン・湯・砂糖・香料などを混ぜて作った飲料)
neigh	馬のいななき / 〈馬が〉いななく,ヒヒーンと鳴く
neighbor,neighbour	『隣人』,隣国,隣国人,隣の席の人;隣にあるもの / 同胞,仲間 / 《『neighbor』 『on』+『名』》(…に)隣接する
neighborhood,neighbourhood	〈C〉『近所』,近隣 / 《the ~》《集合的に》『近所の人々』 / 〈C〉街区,地区;住宅地;近隣社会
neighboring,neighbouring	《名詞の前にのみ用いて》『近くの』;隣の
neighborliness,neighbourliness	隣人らしさ;隣人愛,親しい隣人関係
neighborly,neighbourly	隣人らしい;人付き合いのよい
neither	《単数名詞を伴って》(二つのうちの)『どちらの…も…ない』,…のどちらも…でない / (二つのうち)『どちらも…ない』 / 《neither…nor~の形で》…『でも~でもない』,また…もしない,…もまた…でない / 《否定文(節)に続いて》…『もまた』…『ない』,…でもなくまた…でもない
nelson	(レスリングの)首固め
nem con	=nemine contradicente 満場一致で
nematode	線虫(環節のない細長い虫)
neoclassical	新古典主義の,新古典派の
neoclassicism	(美術・文学などの)新古典主義
neocolonialism	(強国の新興独立国にする)新植民地主義
neodymium	ネオジム(希土類金属元素:化学記号は『Nd』)
neologism	〈U〉新語の使用 / 〈C〉新語,新語釈
neon	ネオン(気体元素;化学記号は『Ne』)
neon light	ネオン燈
neon sign	ネオンサイン
neonatal	新生児の
neonate	新生児
neophyte	新改宗者,新たに洗礼を受けた人 / 初心者,初学者
neoplasm	(体内にできる)新生物;腫瘍(しゅよう)
nepenthe	〈U〉〈C〉悲しみや苦しみを忘れさせてくれる薬;(一般に)忘却を誘うもの / ウツボカズラ(熱帯産の食虫植物)
nephew	『おい』(自分や配偶者の兄弟姉妹のむすこ)
nephritis	腎炎(じんえん)
nepotism	(官職任用の際の)縁者びいき,同族登用
neptunium	ネプトニウム(放射性元素;化学記号は『Np』)
nerve	〈C〉『神経』 / 〈C〉《複数形で》『神経過敏』,いらだち / 〈U〉『勇気』,度胸(courage) / 〈U〉《時にa ~》厚かましさ,ずぶとさ;無礼 / 〈C〉葉脈;(昆虫の)翅脈(しみゃく) / 〈人,特に自分〉'に'力を与える,'を'元気づける
nerve cell	神経細胞
nerve center	神経中枢
nerve fiber	神経繊維
nerve gas	神経ガス(呼吸神経などを冒す軍事用毒ガス)
nerve-racking, nerve-wracking	神経にさわる,いらいらさせる
nerveless	勇気のない,意気地のない,力のない(weak) / 冷静な,落ち着いた(calm) / 神経のない;葉脈(翅脈)のない
nervous	『神経の』 / 『神経質な』,神経過敏な / 『心配な』,不安な
nervous breakdown	神経衰弱
nervous system	《the ~》神経系統
nervously	神経質に,びくびくして,いらいらして
nervousness	神経質なこと,神経過敏;おく病
nervy	《米話》ずうずうしい,厚かましい(bold) / 《英話》神経質な;神経衰弱の
ness	《古》岬(みさき)
nest	(鳥・昆虫・魚類・小動物などの)『巣』,巣穴 / 《集合的に》巣の中の鳥(動物など),(昆虫などの)群れ / 居ごこちよい場所,落ちつける場所 / (犯罪などの)温床;(悪党などの)巣窟(そうくつ) / (入れ子式・重箱式などになった物の)一組,一そろい《+『of』+『名』》 / 巣を作る,巣ごもる / …'を'巣に入れる / (巣に入れるように)…'を'すっぽり収める / …'を'入れ子式にする,重ね合わせる
nest ce pas	そうでしょ,そうじゃないかい(=Isn't it [so]?)
nest egg	擬卵,抱き卵(めんどりが卵を産むのを促すために巣に入れておく陶製の卵) / (不時の支出,将来のために)用意の金,貯金
nesting	《英》(卵を取るための)鳥の巣捜し
nestle	《場所を表す副詞[句]を伴って》ここちよく(ぴったりと)落ち着く / (…に)…'を'ここちよく落ち着かせる《+『名』+『in(into)』+『名』》 / (…に)…'を'すり寄せる《+『名』+『on(against)』+『名』》
nestling	(巣離れするには早すぎる)ひな鳥
net	(魚・鳥・昆虫などを捕らえる)『網』;(人・物を保護するための)網,ネット;(各種球技用の)ネット;(ベール・カーテンなどに用いる)ネット / わな,落とし穴 / (電話・ラジオなどの)情報網,通信網(network) / …'を'網に作る(編む) / …'を'網で捕らえる / …'を'網でおおう;…'に'網を張る / 《名詞の前にのみ用いて》正味の / 正味;正価;純益,実収入 / …'の'純益を上げる
net ton	〈C〉容器などを除いた中身だけの重さ / 〈U〉正味トン(貨物の重量を表す単位)
netball,net ball	ネットボール(バスケットボールに似た英国のゲーム)
nether	《名詞の前にのみ用いて》下の
nethermost	いちばん下の
netherworld	下界,地獄
nett	=net
netting	(製品を作る材料としての)網 / 《集合的に》網細工,網製品 / 網を編むこと;網打ち
nettle	イラクサ(とげのある雑草) / …'を'ちくちく刺す / …'を'いらだたせる
nettle rash	じんましん
nettlesome	いらいらさせる,しゃくにさわる
network	〈U〉〈C〉網,網細工 / 〈C〉『網状のもの』 / 〈C〉(ラジオ・テレビの)放送網
neural	神経[系統]の
neuralgia	神経痛
neuralgic	神経痛の
neurasthenia	神経衰弱
neurasthenic	神経衰弱の / 神経衰弱症患者
neuritis	神経炎
neurologist	神経学者,神経科医
neurology	神経学(神経・神経系の病気に関する学問)
neuron	神経単位,神経細胞,ニューロン,ノイロン
neurosis	神経症,ノイローゼ
neurotic	神経症の,ノイローゼの / 神経症患者
neut.	neuter
neuter	(文法で)中性の / (文法で)中性,中性名詞(形容詞,代名詞) / …'を'去勢する
neutral	『中立の』;中立国の / 『公平な』,不偏不党の / (人・物が)特色のはっきりしない;(色が)はっきりしない,くすんだ / (酸性でもアルカリ性でもない)中性の / (電気が)中性の,(物体が)帯電していない / (自動車などのギアが)ニュートラルの / (文法で)中性の / 〈C〉(戦争・論争などで)中立の人;中立国民;中立国 / 〈C〉くすんだ色,灰色 / 〈U〉(自動車などのギヤの)ニュートラル(動力のかかっていない状態・位置)
neutral spirits	中性スピリット(ウィスキーなどの調合用アルコール)
neutralism	(外交問題などの)中立主義政策
neutrality	中立
neutralization,neutralisation	中立化 / 中和
neutralize,neutralise	…'を'中立化する,'の'中立を宣言する / (反対の作用で)…'を'打ち消す,無効にする / (化学作用で)…'を'中和する / 〈電荷など〉'を'中性にする
neutralizer	中立化させる人;中和剤
neutrino	中性微子(放射性物質の崩壊のとき放出される素粒子)
neutron	中性子,ニュートロン(原子核の構成要素の一つ)
neutron bomb	中性子爆弾
never	《文の否定》(1)『かつて』…『ない』,一度も…しない(at no time) / 『全く』…『ない』,『決して』…『ない』(not … at all) / 《次に来る語句の否定》『少しも』…『ない』 / 《驚き》まさか,とんでもない
never more	もう再び…しない(never again)
never-ending	果てしのない
never-never land	まぼろしの国,夢の国
nevertheless	『それでもやはり』 / 『それにもかかわらず』
nevus	母斑(ぼはん)(先天性のあざ・ほくろ・そばかすなど)
new	(その状態になってまだ時間がたっていなくて)『新しい』;《名詞の前にのみ用いて》新しく発見(発明)された,新しく来た / 《名詞の前にのみ用いて》目新しい,初めて聞く,なじみのない / 《補語にのみ用いて》(人が)(…に)『まだ慣れていない』,(…を)よく知らない《『to』+『名』》 / 《補語にのみ用いて》(人が)(…から)出てきたばかりの《+『from』+『名』》 / 《名詞の前にのみ用いて》まだ着た(使った)ことがない,新品の / 新たに始まる;(肉体的・精神的に)一新した / 《おもに複合語を作って》最近(recently);新たに,新しく(newly)
new blood	(企業・組織・チームなどの)新しい血,新人
new math	新数学(集合の概念から出発する数学の一方法)
new moon	新月,三日月 / 新月の出る期間
new town	(周到な都市計画に基づく)ニュータウン
new wave	ニューウェーブ(1970年代後半から1980年代に欧米で流行した音楽・芸術運動) / 新しい潮流,新風
new-fashioned	新式の,新流行の
newborn	生まれたばかりの / 生まれ変わった,再生の
newcomer	(…に)新しく入った人,新入者《+『to』+『名』》
newel	(らせん階段の軸になる)親柱;(階段の手すりの)親柱
newfangled	《名詞の前にのみ用いて》《やや軽べつして,またはこっけいに》 / 新奇な,新式の / 新しがり屋の
newly	『最近』,近ごろ / 『新たに』,再び
newness	新しさ
newpenny	(英国の)新ペニー(硬貨)
news	(新しい)『報道』,記事;(一般的に)知らせ,たより / (耳新しい)事件,でき事 / 〈C〉ニュース
news agency	通信社
news conference	=press conference
news media	ニュース媒体(新聞・ラジオ・テレビなど)
newsagent	=newsdealer
newsboy	新聞売り子,新聞配達少年
newscast	(ラジオ・テレビの)ニュース放送番組
newscaster	ニュース放送者,ニュース解説者
newsdealer	新聞(雑誌)販売人(《英》newsagent)
newsgirl	(女性の)新聞売り,新聞配達婦
newsletter	(定期講読者向けの)時事通信;社報,公報,回報,PR誌
newsman	新聞売り / 報道記者;ニュース解説者
newsmonger	うわさ好きな人,おしゃべり
newspaper	(また《話》『paper』)〈C〉『新聞』 / 〈C〉新聞社 / 〈U〉新聞印刷用紙(newsprint)
newspaperman	(また『newspaper reporter』)新聞記者 / 新聞経営者
newspaperwoman	婦人新聞記者
newsprint	新聞印刷用紙
newsreel	(短い)ニュース映画
newsroom	(新聞社・放送局の)ニュース編集室 / 新聞雑誌閲覧室
newssheet	(1または2ページの)1枚新聞
newsstand	(駅・街頭などの)新聞雑誌売場
newsvendor,newsvender	新聞雑誌販売人 / 新聞雑誌自動販売器
newswoman	婦人新聞記者,婦人報道員
newsworthy	報道価値のあるニュース(記事)になる
newsy	ニュース(話題)の多い / おしゃべりな
newt	イモリ
newton	ニュートン(力の単位)[Sir Isaac Newtonの名にちなむ]
next	(時間・順序が)『次の』,すぐ後に続く;来…,翌… / (場所・位置が)『いちばん近い』,隣の / (時間・順序などの点で)『次に』,今度は / 次の人,次のもの
next-door	隣の家(建物)に;《名詞の後に置いて形容詞的に》隣の / 隣に住む
next-of-kin	最近親者,近親者,親族
nexus	連鎖;関係 / (文法で)主語述語関係
niacin	=nicotinic acid
nib	ペン先 / (一般的に)とがった部分,先端(tip) / (鳥の)くちばし
nibble	(…を)少しずつかじる,少しずつ食べる,つつく《+『away at』(『on』+『名』) / (相手の申し出などに)思わせぶりな催度を示す,乗るようなふりをする《+『at』+『名』》 / …'を'少しずつ食べる,つつく;…'を'かじり取る《+『away(off)』+『名』,+『名』+『away(off)』》 / かじり取って…'を'作る / (…を)つつくこと,かじること《+『at(on)』+『名』》 / (食物の)一口の量,少量
nibs	親分,大将,ボス
nice	(物事が)『良い,気持ちよい』(pleasant) / (人が)『親切な』,思いやりのある / 『十分満足のできる』,すばらしい,質のいい / 微妙な,デリケートな;精密な,正確な / 育ちのいい,礼儀正しい;洗練された
nice-Nellyism	お上品ぶり,淑女ぶり,お上品な言い回し,淑女ぶること
nicely	見事に,気持ちよく;うまく / 精密に
niceness	とてもよいこと,すばらしさ,けっこうなこと / 精密さ
nicety	〈U〉正確さ,的確さ,精密さ / 〈C〉《複数形で》微妙な点(相違),細かな点 / 〈C〉《複数形で》すてきなもの;優雅なもの,洗練された教養(態度など)
niche	壁がん(像・花びんなどを置く壁のくぼみ) / (…に)ふさわしい場所(地位,仕事),適所《+『for』+『名』》
nick	刻み目(notch) / 表面だけの切り傷,かすり傷 / …'に'刻み目(傷)をつける・「in the nick of time」で「きわどい時に, ちょうどよく」 / 状態,体調
nickel	〈U〉『ニッケル』(金属元素;化学記号は『Ni』) / 〈C〉(米国・カナダの)5セント白銅貨 / 〈C〉(一般に)ごくわずかの金 / …'に'ニッケルめっきをする
nickel silver	洋銀(ニッケル・銅・亜鉛の合金)
nickel-plate	{動}防錆や装飾目的で行うニッケルめっきを施す処理を行うこと / 〈C〉ニッケルめっきされた金属板
nickelodeon	(昔の)5セント映画館 / 初期のジュークボックス
nicker	《スコットランド英語》〈馬が〉いななく / (馬の)いななき / 《英俗》1ポンド,《豪俗》金
nicknack	=knickknack
nickname	(…に対する)『あだ名』,通り名,(…の)愛称,略称《+『for』+『名』》 / 《『nickname』+『名』+『名』(『形』)》(…と)…'に'あだ名(愛称)を付ける,'を'あだ名で呼ぶ
nicotine	ニコチン(たばこに含まれる無色の毒物)
nicotinic acid	ニコチン酸
niece	『めい』(自分や配偶者の兄弟姉妹の娘)
niff	悪臭,臭気
nifty	しゃれた,いきな;うまくできた
niggard	けちんぼ(miser) / =niggardly
niggardliness	けちなこと,しみったれ
niggardly	けちな,しみったれた;(…に)けちけちする《+『of』+『名』》 / けちくさい,わずかの,乏しい / けちけちと,物惜しみして(stingily)
nigger	(黒人に対する極めて侮蔑的・差別的表現)
niggle	(ささいなことに)念を入れ過ぎる,あれこれ言う《+『about』(『over』)+『名』》 / (人などを)いらいらさせる《+『at』+『名』》
niggling	ささいなことにこだわる;いらいらさせる / (作品などが)細部に凝りすぎた,(仕事などが)細かくてめんどうな
nigh	近くの(near) / 近くに(で) / ほとんど / …の近く(そば)に
night	〈C〉〈U〉『夜』,晩,夜間 / 〈U〉(夜の)暗やみ,夜陰 / 〈U〉《文》(精神的に)まっ暗な状態(時),やみ / 〈C〉(特定の行事・目的に当てられる)晩,夜 / 『夜の』,夜間[用]の;夜勤の;夜行[性]の
night bird	《話》=night owl / 夜鳥(フクロウ,ナイチンゲールなど)
night blindness	夜盲症,鳥目
night crawler	夜間にはい回る大ミミズ
night owl	夜ふかしをする人
night porter	(ホテルのフロントなどの)夜間勤務者
night safe	(銀行の)夜間金庫
night school	夜間学校
night soil	(肥料にされる)糞尿(ふんにょう)
night table	寝室用小テーブル
night watch	〈U〉夜警 / 〈C〉《単数・複数扱い》夜間警備員 / 〈C〉夜警時間
night watchman	〈C〉(工場などの)夜間警備員
nightcap	ナイトキャップ(夜寝るときかぶる帽子) / 寝る前に飲む酒
nightclothes	寝巻き
nightclub	ナイトクラブ
nightdress	=nightgown
nightfall	日暮れ
nightgown	(婦人・子供用のゆったりした)寝巻き(《英》nightdress)
nighthawk	(北米産の)ヨタカ(夜鳥) / 《話》=night owl
nightie	=nightgown
nightingale	ナイチンゲール,サヨナキドリ(ヨーロッパ産ツグミ科の小さな赤褐色の渡り鳥;雄は特に春の夕方から夜半にかけて美しい声で鳴く)
nightjar	ヨタカ(ヨーロッパ産の夜鳥)
nightlife	(観劇・ナイトクラブなどでの)夜の楽しみ,夜遊び
nightlight	終夜灯(寝室・病室などで夜通しつけたままにしておく明かり)
nightline	(夜間水中に仕掛けておく)夜釣り糸
nightlong	一晩じゅうの,徹夜の / 一晩じゅう,徹夜で
nightly	夜の,夜間の;毎晩の,夜ごとの / 毎晩,夜ごとに
nightmare	悪夢 / 悪夢のような経験(状態) / 夢魔(睡眠中の人を息苦しくさせるという魔女)
nightmarish	悪夢のような;恐ろしい
nightrider	(特に南北戦争後の)夜の騎馬暴力団員
nights	夜な夜な,毎晩
nightshade	ナス属の種々の有毒植物,(特に)イヌホウズキ / ナス科植物の総称
nightshift	〈C〉(昼夜交替制の)夜勤[時間] / 〈U〉《the ~》《集合的に》(工場などの)夜間労働者
nightshirt	(男子用の)長いシャツ型の寝巻き
nightspot	ナイトクラブ
nightstick	(警官の)警棒
nighttime	夜間
nightwalker	夜間うろつきまわる人(泥棒,売春婦など)
nightwear	寝巻
nigritude	黒さ,漆黒,まっ暗やみ
nihilism	虚無主義,ニヒリズム
nihilist	虚無主義者 / 無政府主義者
nihilistic	虚無的な,虚無主義の,ニヒルな
nil	無(nothing) / 《英》(スポーツの得点で)ゼロ
nimbi	nimbusの複数形
nimble	(人・動作などが)すばやい,軽い,敏しょうな・理解が早い,分かりが早い・鋭敏な
nimbleness	すばやさ,敏しょう
nimbly	すばやく,機敏に
nimbostratus	(雨・雪を降らせる)乱層雲
nimbus	(宗教画などの)後光 ・光輪・(人・もの・場所にただよう)輝かしいふんい気; 後光 (halo)・光輪; 栄光;雨雲
nincompoop	ばか者,まぬけ(fool)
nine	〈C〉(数の)『9』;9の記号(9,IXなど) / 〈U〉9時,9分;9歳 / 〈U〉《複数扱い》9人,9個 / 〈C〉9人(9個)一組のもの;野球チームのメンバー / 〈C〉(カードゲームの)9の札 / 《the N-》9人の学芸の女神(the nine Muses) / 『9の』,9人の,9個の / 《補語にのみ用いて》9歳の(で)
nine days' wonder	(10日もたてば忘れられる)ほんのしばらく注意を引くことがら,すぐに忘れられてしまう物事,人の噂も75日
ninefold	9倍の,九重の / 9倍に,九重に
ninepins	《単数扱い》九柱戯(とっくり型のピン9本を並べ,玉をころがして倒すボウリングに似た野外遊戯) / 《複数扱い》九柱戯で使うピン
nineteen	〈C〉(数の)『19』;19の記号(19,『XIX』など) / 〈U〉(24時間制で)19時,19分;19歳 / 〈U〉《複数扱い》19人,19個 / 〈U〉19人(19個)一組のもの / 『19の』,19人の,19個の / 《補語にのみ用いて》19歳の(で)
nineteenth	《the~》『第19の』,19番目の / 19分の1の / 〈U〉《the~》『第19番目』[のもの];(月の)19日 / 〈C〉19分の1
ninetieth	《the~》『第90の』,90番目の / 90分の1の / 〈U〉《the~》『第90番目』[のもの] / 〈C〉90分の1
ninety	〈U〉(数の)『90』;90の記号(90,XCなど) / 〈U〉90歳 / 〈U〉《複数扱い》90人,90個 / 《the nineties》(世紀の)90年代;(年齢の)90歳代 / 『90の』,90人の,90個の / 《補語にのみ用いて》90歳の(で)
ninny	ばか
ninon	ニノン織り(軽いドレス用絹布)・薄絹
ninth	《the~》『第9の』,9番目の / 9分の1の / 〈U〉《the~》『第9』・9番目[のもの];(月の)9日 / 〈C〉9分の1
niobium	ニオビウム(金属元素;化学記号は『Nb』)
nip	…'を'はさむ,つねる,ぎゅっとかむ / (…から)…'を'摘み取る,はさみ切る《+『of』+『名』(+『名』+『off』)+『from』+『名』》 / 《まれ》…'を'縮みあがらせる,ずきっと痛くする / 'を'成長(進展)を止める / はさむ,つねる,かむ / 《おもに英話》《方向などを表す副詞を伴って》すばやく動く,急ぐ / 〈U〉〈C〉はさむ(つまむ,かむ)こと / 〈C〉《しばしばa~》肌を刺す寒さ / 〈U〉《しばしばa~》《米》強い(刺激的な)味,つんと鼻にくる風味 / 〈U〉〈C〉《英話》急ぐこと / 酒の一口,すすり
nipper	《複数形で》はさむ物;やっとこ,くぎ抜き,毛抜き,針金切りなど / 《英話》少年
nipping	(風・寒さなどが)身を切るように冷たい / (言葉・調子などが)辛らつな
nipple	(人間や動物の)乳首 / 乳首に似た物;《米》(ほ乳びんの)乳首
nippy	すばしこい / 身を切るような / ぴりっとくる
nirvana	〈U〉《『N-』》ねはん(仏教の用語) / 〈C〉〈U〉苦痛・悩み・世俗を超越していること(した場所)
nisi	(法律で)仮判決の(一定期間内に異議を申し立てない限り効力を発する)
nit	(シラミなどの)卵,幼虫 / 《英》=nitwit
niter,nitre	硝酸カリウム,硝石(火薬原料) / 硝酸ナトリウム,チリ硝石(肥料用)
nitpick	(…のことで)こまごまとこだわる,せんさくする《+『at』+『名』》
nitpicker	細かいことにこだわる人,あら探しする人
nitrate	硝酸塩 / 硝酸塩類化学肥料
nitre	=niter
nitric	窒素の,窒素を含む
nitric acid	硝酸
nitride	窒化物
nitrify	…'を'硝化する,亜硝酸に変える / …'に'窒素[化合物]をしみこませる
nitrite	亜硝酸塩
nitrocellulose	ニトロセルロース,硝酸繊維素
nitrogen	『窒素』(気体元素;化学記号は『N』)
nitroglycerin, nitroglycerine	ニトログリセリン(ダイナマイトの原料;俗称nitro)
nitrous	(特に3価の)窒素の,窒素を含む
nitrous acid	亜硝酸
nitrous oxide	=laughing gas
nitty-gritty	《the~》《俗》物事の核心,(困難な)中心問題
nitwit	《話》ばか,あほう
nix	無,皆無 / いや,だめで(no) / {間} / やめろ,いやだ;気を付けよ / …'を'拒否する,断る
nixie	宛先不明郵便物
no	《名詞の前に置いて》『一つも』(『一人も,少しも』)…『ない』 / 《補語につけて》『決して…でない』 / 《省略文で》…なし;…お断り / 《話》少ししか(あまり)…ない / (肯定の問いに対して)『いいえ』;(否定の問いに対して)はい,ええ / 《not, norの前に挿入して》『いや』,否 / 《形容詞の前に置その形容詞を否定して》…どころではない / 《比較級の前に置いて》ちっとも…でない,…と全く同じ / 《… or no の形で》…であってもなくても / 《驚き・困惑・不信などを表して》とんでもない / 《単数形で》『拒否』,「『いいえ』」という返事 / 《複数形で》反対[投]票
no ball	(クリケットの)反則投球
no doubt	確かに,きっと,恐らく
no load	(販売手数料なしで売られる)オープン投資信託
no one	『だれも』…『ない』
no-account	ろくでなし,能なし / ろくでなし,能なしの
no-fault	(自動車の)無過失保険[制度] / (自動車の)無適失保険[制度]の / (離婚が)どちらに原因があるのかを問わず認められる
no-frills	余計なものがついていない
no-fund	=no-load
no-go area	(抗争する集団の)縄張り,不可侵領域
no-good	役立たずの / 役立たず,うどの大木
no-knock	(法律・条項などで)警官の無断立ち入りを許す
no-load	=no-load fund,ノーロードファンド,手数料不要のミューチャルファンド(販売手数料 = load は不要だがアドバイスもない)
no-man's-land	(交戦中の両軍前線間の)中間地帯 / (通例不毛の)所有者のない土地 / どちらともつかない状態,はっきりしない分野
no-no	許されない事(物),いけない事
no-par	額面価格を明記しない
no-return	(飲物の空びんなどが)返却不要の
no-show	(旅客機・列車などの座席を予約しながら)出発までに来ない客
no-trump	(ブリッジで)切り札なしの宣言(勝負手)
nob	金持ち,名士,上流人 / 頭
nobble	〈人など〉'の'歓心を買う / 〈物など〉'を'不正手段で勝ち取る,だまし取る / (薬などを与えて)〈競走馬〉'を'勝てなくする
nobelium	ノーベリウム(放射性元素;化学記号は『No』)
nobility	《the nobility》《複数扱い》『貴族階級』(英国の貴族階級は「duke公爵,marquis侯爵,earl伯爵,viscount子爵,baron男爵」がある.baronetは准男爵,knightは騎士) / 貴族の位;貴族の身分 / 『高貴さ』,気高さ
noble	高貴の;貴族の / 高潔な,気高い / (姿・規模などが)壮大な,堂々とした;すばらしい / (金属が)腐食しない / 《複数形で》(特に中世の)貴族
noble-minded	気高い,高潔な・心の大きい
nobleman	貴族
noblesse oblige	高貴な身分に伴う(徳義上の)義務,ノブレス・オブリージュ・高い身分には(道徳上の)義務が伴うこと
noblewoman	(女性の)貴族
nobly	身分高く,貴族にふさわしく / 気高く,壮大な,雄々しく
nobody	『だれも…ない』(not anybody) / 取るに足らない人,つまらぬ人間
nocturnal	夜の,夜間の;夜に起こる / (動物が)夜行性の / (植物が)夜咲きの
nocturne	夜想曲,ノクターン / 夜景画
nod	(承諾・あいさつ・合図などで)『うなずく』,会釈する / (眠くて)『こっくりする』,(油断して)うとうとする《+off》 / 〈草木・穂などが〉揺れる / (承諾・あいさつなどで)〈頭〉'を'『うなずかせる』 / …'を'うなずいて示す / 《副詞[句]を伴って》〈人〉'に'うなずいて示す / 《同意・承諾・あいさつ・命令など,また時には拒絶を表して》(…に対する)『うなずき』,『会釈』《+『to』+『名』》;(眠気による)こっくり
nodal	節(こぶ)の[ような]
nodding acquaintance	《単数形で》(…と)会えば会釈する程度の間柄;(…についての)ごく浅い知識《+『with』+『名』》 / 会えば会釈する程度の浅い知り合い
noddle	頭,おつむ
noddy	クロアジサシ(熱帯に棲む鳥の一種) / ばか者,あほう
node	(茎・幹の)節(ふし) / (体組織にできた)結節,こぶ(リンパ瘤(りゅう)など) / (天体の軌道の)交点 / (物事の)中心点
nodular	節(ふし)の[ような]
nodule	(鉱石などの)小塊 / (植物の茎・根,動物の組織にできる)小結節,こぶ
nog	卵酒[類]
noggin	小型ジョッキ / (特にアルコール飲料の)少量(約1/4パイント=0.15l) / 《俗》(人の)頭
nohow	どうしても…ない
noise	〈C〉〈U〉(特に,大きなまたは不快な)『音』,物音 / 〈C〉〈U〉(街・往来などの)『ざわめき』,騒音,騒々しい声 / 〈C〉(一般に)物音 / 〈U〉(ラジオ・テレビなどの)ノイズ,雑音 / …'を'広める,言い触らす《+『名』+『about』(『abroad, around』)》 / 音を立てる;大声で話す《+『about』(『around, abroad』)》
noise pollution	騒音公害
noiseless	音を立てない,静かな
noisemaker	(祝賀・儀式・催しなどでにぎやかに鳴らし立てる)角笛,ガラガラ,鳴子 / (一般に)騒音を立てる人(物)
noisily	やかましく,騒がしく
noisiness	騒ぎ,騒がしさ
noisome	有害な,健康に良くない / (におい・音などが)いやな,不快な
noisy	(人・声などが)『やかましい』,騒々しい,(場所が)騒音に満ちている
nol-pros	(訴訟中止の旨を法廷記録に残して)〈原告が〉…'の'訴訟を取り下げる
nolle prosequi	(原告の)訴訟取り下げ
nolo contendere	不抗争の答弁(刑事訴訟で被告人が有罪を認めないが抗弁はしないということ)
nom de guerre	仮名,筆名,(戦時)仮名,ペンネーム
nom de plume	(作家の)ペンネーム(pen name)
nom.	nominative
nomad	《しばしば複数形で》遊牧民 / 放浪者
nomadic	遊牧の / 放浪の
nomenclature	(各分野で用いる)専門用語法 / (体系に基づく)科学的命名法
nominal	名目上の,名義だけの / (実際の価値に比べて)ごくわずかの,おしるし程度の / 名詞の,名詞として用いられた
nominate	(…の候補者として,…に)…'を'『指名する』《+『名』+『for』+『名』》 / (…に)…'を'『任命する』(appoint)《+『名』+『to』(『as』)+『名』》
nomination	指名[権],任命[権];(…を…に)指名(任命)すること《+『of』+『名』+『to』+(『as, for』)+『名』》
nominative	(文法で名詞・代名詞が)主格の / 指名された / 〈C〉主格の形
nominator	指名(任命)する人
nominee	(…の候補として)指名された人《+『for』+『名』》 / (…に)任命された人《+『to』+『名』》
non sequitur	前提と合致しない結論(《略》『non seq』.)
non troppo	(演奏者への指示で)ほどよく,過度にわたらぬように
non-U	(特に言葉や行動が)上流階級的でない,上流階級にふさわしくない,上流社会的でないこと,非上流社会人,上流社会的でない
non-iron	(衣類などが)アイロンがけ不要の
nonage	未成年[期](英米では18歳未満) / 発達の初期
nonagenarian	90歳代の / 〈C〉90歳代の人
nonaggression	不侵略
nonagon	九辺形,九角形
nonaligned	(国家が)非同盟の,中立の
nonalignment	非同盟,中立[状態]
nonassertive	(文や句が)単純肯定でない
nonce	目下, 当分; 臨時の
nonce word	(ある事柄・状態の描写のために作られた)造語,間に合わせに作った語(EnglishにJapaneseのJapを合成して作ったJaplish「和製英語」など)
nonchalance	無関心,むとんじゃく,のんき
nonchalant	むとんじゃくな,無関心な;(…に)むとんじゃくである《+『about』(『over』)+『名』》
noncom	下士官[noncommissioned officerの短縮形]
noncombatant	非戦闘員(軍医・従軍牧師など) / 戦時の一般市民
noncommissioned officer	(陸軍の)下士官(曹長・軍曹(ぐんそう)(sergeant)と伍長(ごちょう)(corporal);海軍ではpetty officerという;《略》『Nco,N.C.O.』)
noncommittal	(考え・行動など)どっちつかずの
noncompliance	(命令・要求・規則などに)不服従
nonconductor	(熱・電気・音などの)不導体
nonconformism	非同調主義;非国教主義
nonconformist	《しばしば『N-』》非国教徒(英国国教会に属さないプロテスタント)・既存の教会(制度など)に従わない人
nonconformity	(規則などに)従わないこと,協調(順応)しないこと《+『to』(『with』)+『名』》 / 《しばしば『N-』》非国教主義;非国教徒
noncontributory	(年金が)雇用者負担の
noncooperation	協力しないこと;(政府に対する)非協力
nondairy	乳成分なしの,乳成分を使っていない
nondescript	目立った特色のない / 〈C〉 / 特徴のない人(もの)
none	《『none of』+『名』の形で》(…の)『どれも』,『何も,だれも,少しも』)…『でない』 / 《no+名詞に代わって》『少しも』(『一人も,一つも』)…『ない』 / 《文》《主語として単独で用いて》『だれも』…『ない』 / 《『none too』…の形で》『少しも』(『決して』)…『ない』 / 《『none the』+『比較級』の形で》(…だからといって)少しも…でない《+『for』+『名』(do『ing』》
nonentity	〈C〉取るに足りない人(物) / 〈C〉実在しない物,架空の物 / 〈U〉実在しないこと
nonessential	本質的でない / 本質的でないもの
nonesuch	無比(無類)の人物
nonetheless	『それでもなお』
nonevent	期待はずれの[のこと]
nonexistence	〈U〉実在しないこと;〈C〉実在しない物
nonexistent	実在しない,想像上(架空)の(unreal)
nonfiction	ノンフィクション(小説・詩・ドラマ以外の散文学;伝記・紀行・随筆・歴史など) / 《集合的に》ノンフィクションの作品
nonflammable	不燃性の
nonfood	食料品以外の商品
nonhero	主人公らしくない主人公,平凡な主人公,アンチヒーロー
nonintervention	(他国の政策・他人の私事に対する)不干渉,不介入《+『in』+『名』》
nonmetal	非金属
nonobjective	非具象的な,抽象的な
nonobservance	(法規・習慣などの)違反
nonpareil	無比の,無類の / 比類のない人(もの),絶品 / 6ポイント活字
nonpartisan,nonpartizan	無党派の,無所属の;一党一派に偏しない
nonpayment	(…の)不払い,未払い《+『of』+『名』》
nonplus	…'を'困惑させる;…'を'途方に暮れさせる
nonproductive	(土壌・畑・鉱山などが)生産物を産出しない,生産能力のない / 生産と直接関係のない
nonprofit	非営利的な
nonproliferation	(核兵器などの)拡散防止;(望ましくないものが)増える(拡がる)のを防ぐこと
nonrepresentational	非描写的な,非具象的な,描象的な
nonresident	(ある一定の場所に)住んでいない,居住してない / 非居住者
nonrestrictive	(文法で)非制限的な
nonrigid	堅くない,柔軟な / (飛行船が)軟式の
nonscheduled	予定外の;(飛行機運航が)不定期の
nonsectarian	特定の宗派に属さない,無宗派の
nonsense	『無意味な言葉』(『行為』),たわごと;ばかげた考え(振舞い) / くだらないこと(もの)(trifles) / ばかな,くだらん
nonsensical	ばかげた,無意味な
nonsked	不定期航空会社
nonskid	(タイヤが)すべり止めをした
nonsmoker	喫煙しない人 / 《英》(列車などの)禁煙車
nonstandard	(言葉・語法・発音などが)標準的でない
nonstarter	見込みのない人;可能性のない考え
nonstick	(フライパンなどが)こげつかない,テフロン加工の
nonstop	途中停車(着陸)しない,直行の / 途中で停車(着陸)しないで / 《話》休まずに
nonsupport	扶養義務不履行
nonunion	労働組合に加入しない / 労働組合員を雇っていない
nonverbal	言葉によらない,言葉にならない
nonviolence	(戦術としての)非暴力主義(政策)
nonviolent	非暴力[主義]の
nonvoter	投票しない人,棄権者
nonwhite	白人でない / 〈C〉白人でない人
noodle	ヌードル(平打ちうどんの類;スープなどに入れる) / ばか者 / 《米俗》頭
nook	隅(すみ)(corner);引っ込んだ所 / 隔離された閑静な場所
noon	(また『noonday,noontide,noontime』)『正午』;真昼(midday) / 《the noon》(…の)最盛期《+『of』+『名』》
noonday	=noon 1 / 正午の,正午(真昼)に起こる
noontide	=noon 1
noontime	=moon 1
noose	(一方の端を引っ張ると締まるようになる)輪なわ,引き結び / 《the noose》絞首刑 / 〈動物など〉'を'輪なわ(わな)で捕らえる
nope	いいや,いえ(no)
nor	《neither…nor,で》…『も』,『も』…『ない』,また…ない(or not) / 《not,no,neverなどを含む否定節の後で,さらに次に続く内容を否定して》…『もまた』…『ない』 / 《肯定文の後,または文頭に置いて,次に続く内容を否定して》『そしてまた』…『ない』(and not)
norm	《しばしば複数形で》標準,規準;一般水準;(行動の)規範,ノルマ・基準量(値)
normal	『正常な』,『通常の』,標準の / (人が肉体・知能・情緒の発達において)平均的な,年齢相応の / (線などが)垂直な;(…に)垂直な《+『to』+『名』》・普通の;典型的な;直角をなす (to)・(実験動物が)常態の, 未処置[未免疫]の;(濃度が)規定の・常態;垂線, 法線;平均量[値]正常,通常;標準
normal school	(20世紀初期の)師範学校(今日ではteacher-training college)
normalcy	=normality
normality	正常,常態
normalization,normalisation	正常化;標準化,規準化
normalize,normalise	…'を'正常化する;…'を'規準に合わせる,標準化する
normally	正常に,普通に,常態では;標準的に
normative	標準[通り]の,規範的な
north	《the~》『北』;北方 / 《the~,the N-》北部[地方],北方[地域] / 《the N-》米国の北部諸州(特にOhio川以北のMaryland州・Missouri州を含む諸州;南北戦争で南部同盟諸州と戦った) / 『北の』,北部の,北向きの;北からの / 『北に』,北方へ
north-northeast	北北東 / 北北東へ向かう;北北東からの / 北北東へ(に)
north-northwest	北北西 / 北北西へ向かう;北北西からの / 北北西へ(に)
northbound	北方行きの
northeast	《the~》『北東』(《略》『NE,N.E.』) / 《the~》北東地域,北東部;《the N-》米国北東部[地方] / 北東へ向かう / (風が)北東からの / 北東へ(に)
northeaster	北東の強風
northeasterly	北東の;北東への / (風が)北東からの / 北東へ(に) / (風が)北東から
northeastern	北東の;北東へ向かう / 北東からの / 北東部得典の
northeastward	北東へ(に) / 北東の;北東へ向かう / 北東;北東部
norther	強い北風
northerly	北の;北へ向かう / (風が)北からの / 北へ(に) / (風が)北から
northern	『北の』,河[部]にある;北に向かう / 北からの / 《しばしばN-》北部特有の,北部ふうの;(特に)米国北部の
northern lights	=aurora borealis
northerner	北国の人,北部の人 / 《N-》《米》米国北部人
northernmost	最北の,最北端の
northland	〈C〉北国,(特にカナダ北部やアラスカを指して)北部地方 / =Scandinavia
northward	北へ(に) / 北の;北へ向かう / 北部,北方
northwest	〈U〉《the~》『北西』(《略》『NW,N.W.』) / 《the~》北西地域,北西部;《the N-》米国北西部[地方](特にIdaho,Oregon,Washington州を含む) / 北西へ向かう / (風が)北西からの / 北西へ(に)
northwester	北西の強風
northwesterly	北西の;北西への / (風が)北西からの / 北西へ(に) / (風が)北西から
northwestern	北西の;北西へ向かう / 北西からの / 北西部特有の
northwestward	北西へ(に) / 北西の;北西へ向かう / 北西,北西部
nose	『鼻』 / 《単数形で》(…に対する)『嗅覚』(きゅうかく)《+『for』+『名』》 / (鼻のように)突起した部分;船首,機首 / 《単数形で》(…を)かぎつける力《+『for』+『名』》 / 《副詞[句]を伴って》…'を'鼻で押す,鼻でさわる(こする) / …'を'鼻でかぐ,'を'においをかぐ;…'を'においで知る / (…の)においをかぐ《+『at』+『名』》 / 《副詞[句]を伴って》(用心しながら)鼻先を向けて進む
nose flute	鼻笛(鼻息で鳴らすタイなどの楽器)
nose ring	(牛などを引くための)鼻輪
nosebag	(馬などの頭からつるす)かいば袋
nosebleed	鼻血
nosecone	ノーズコーン(ロケット先端の円錐(えんすい)形部分)
nosedive	〈飛行機が〉急降下する / 《比喩(ひゆ)的に》急に落ちる / (機首を下に向けた)垂直降下,急降下 / 《比喩(ひゆ)的に》(価格などの)急落
nosegay	(特に,服につける香りのよい)小さな花束
nosey	=nosy
nosh	間食をする,つまみ食いする / 《おもに英俗》食べる / 〈U〉食べ物 / 〈C〉《単数形で》食べること
nosh-up	すごいごちそう
nosher	間食の多い人,つまみ食いをする人
nosiness	せんさく好き,おせっかい
nostalgia	ノスタルジア,昔を懐しむ気持ち,懐古の情 / 郷愁
nostalgic	郷愁の,郷愁に満ちた / 昔を懐しむ,懐古にふける
nostalgically	昔を懐しんで,郷愁で
nostril	鼻孔
nostrum	(製造会社が自己宣伝する)妙薬,万能薬 / 《やや皮肉に》(解決のための)妙案,秘策
nosy parker	せんさく好きな人,おせっかいやき
nosy, nosey	せんさく好きの,おせっかいな
not	《助動詞,be動詞,時にhaveと共に,また一般動詞にはdoを添えて文の否定を表して》…『でない』,しない / 《語・句・節を否定して》…『でなく』 / 「not+形(副)」は否定される形容詞・副詞の反対の意味を強調することがある / notの意が及ぶ範囲の違いによって,意味解釈に違いが生じることがある / 《不定詞・分詞・動名詞を否定して》…[『し』]『ない』 / 《all, everyなどとともに用いて部分否定を表して》(全部が…なのでは)『ない』,(必ずしも…では)『ない』 / 《any, eitherなどに伴って全面否定を表して》(全然…)『しない』,(どちらも…)『しない』 / 《省略文でnotを含む句・節の代用として》『そうではない』
not sufficient funds	(銀行の)預金不足
nota bene	= note well(注意せよ) / 注意[せよ]《略》『N.B.,nb.』
notability	〈U〉顕著,著名 / 〈C〉《複数形で》名士
notable	『注目に値する』,目立った / 〈C〉著名人,名士
notably	著しく,際立って / 特に
notarize,notarise	〈公証人が〉〈文書〉'を'公証する,証明する
notary public	公証人
notch	(V字形の)刻み目 / 《米》山あい / 《話》段階(STEP),等級(degree) / …'に'刻み目をつける / 《話》〈競技の得点など〉'を'記録する,〈勝利〉'を'収める
note	〈C〉《複数形で》『覚え書き』,控え,メモ / 〈C〉(本文に対する)『注』,注釈 / 〈C〉(形式ばらない)『短い手紙』,短信;外交上の文書 / 〈U〉『注目』,注意 / 〈U〉『重要性』(importance);顕著 / 〈C〉《単数形で》(声の)調子,(感情などの)しるし,兆候《+『of』+『名』》 / =promissory note / 〈C〉『紙幣』 / 〈C〉音楽;音符;(ピアノなどの)けん / …'を'『書き留める』,記す / …'に'『注意する』;…'と'気づく / (取り立てて)…'に'ついて言う,'を'留意する
notebook	『ノート』,筆記帳
notecase	財布,札入れ
noted	『有名な』,著名な
notepaper	=writing paper2
noteworthy	(物事が)注目に値する,著しい(remarkable)
nothing	『何も…ない』(not anything ,no thing) / 『少しも…でない』 / 〈C〉《単数形で》『重要でないこと(人)』,取るに足りない人 / 〈U〉ゼロ
nothingness	無,空 / 無意義・無価値
notice	〈U〉『人目を引くこと』,注意,注目,関心 / 〈U〉『通告,通知』,警告;(契約解除の正式な)通知,予告 / 〈C〉(…の)『掲示』,はり紙,びら《+『of』+『名』》 / 〈C〉《しばしば複数形で》(新聞・雑誌などにのる)批評,紹介 / (赤ちゃんが)知恵がつく / (視覚・聴覚など五感で)…'に'『気がつく』,'を'認める;(心で)…'に'気がつく(進行形にできない) / …'に'注意を払う,関心を持つ
notice board	=bulletin board
noticeable	人目を引く,目立つ,明らかな / 注目に値する
noticeably	目立って,著しく
notifiable	(伝染病など)届け出ねばならない
notification	〈U〉〈C〉通知,通告,告示 / 〈C〉通知書;届け書
notify	〈人〉'に'『知らせる』,通報する(inform)
notion	〈C〉『心に思うこと』,考え,意見 / 〈C〉『意図』,望み,思いつき / 《複数形で》《米》小間物(針,糸,リボンなど)
notional	概念(上)の,抽象的な,頭の中だけの / 概念語の;(単語が)辞書的意味を持つ
notoriety	(通例悪い意味で)有名,評判
notorious	名高い,(特に)悪名高い,札付きの
notwithstanding	…にもかかわらず / 《文》それにもかかわらず(nevertheless)
nougat	ヌガー(木の実がはいった砂糖菓子)
nought	=naught
noughts and crosses	○×ゲーム(○×を5目並べのように三つ続くよう並べ合う;(《米》tick-tack-toe))
noun	『名詞』
nourish	…'を'『養う』;…'に'栄養を与える / …'を'発展させる,助長する / (心に)〈ある感情〉'を'『抱く』《+『名』+『in』+『名』》
nourishing	滋養に富んだ,栄養のある
nourishment	滋養分,栄養物,食物 / 養育,育成
nous	〈C〉知性 / 判断力 / 思慮 / 《英》常識 / 実務能力 / 《哲》理性
nouveau riche	にわか成金
nova	新星(突然明るくなり,また元に戻る星)
novel	『新奇な』,ざん新な / (長編の)『小説』
novelette	〈C〉中編小説(短編より長く、長編より短い小説) / (けなして)感傷的すぎる小説 / 通俗小説
novelettish	中編小説的な;感傷的な
novelist	小説家
novella	《古》(一つのでき事を描いた)短編物語 / 中編小説
novelty	〈U〉『新奇さ』,『珍しさ』,ざん新さ(newness) / 〈C〉『珍しいもの』,珍しいこと / 〈C〉《複数形で》(装飾品やおもちゃなどの)珍奇な商品,新型商品
novena	(カトリックで)9日間の祈り(修業)
novice	初心者,新米 / 見習い修道士(女)
novitiate,noviciate	〈U〉初心者であること;見習い期間 / 〈C〉初心者,新米;見習い修道士(女) / 〈C〉見習い修道士(女)の修練所
now	『今』,現在は / 《しばしばrightを伴って》『ただちに』,すぐに / (物語の中などで)そのとき / 現状では,今はもう / 《しばしばthatを伴って》『今や』…『なのだから』 / 『現在』,今 / 《話題の転換・慰め,非難・命令・懇願などの調子を込めて》『さて』,ところで,さあ
nowadays	(特に過去と比べて)『今日では』,このごろは
noway,noways	全然…ない,決して…しない(not at all)
nowhere	『どこにも』(『どこへも』,『どこでも』)…『ない』 / どこにもない場所(no place);どことも知れぬ場所 / 無名[の状態]
nowise	=noways
noxious	(健康上)有害な,身体に悪い / (道徳的に)有害な,不健全な
nozzle	(ホース・ふいごなどの)筒先,吹き口,ノズル
nt.wt.,n.wt.	net weight 正味[重量]
nth	n番めの,n倍の,n次の
nu	ニュー(ギリシア語アルファベットの第13字Ν,ν;英語のN,nに相当)
nuance	(意味・色彩などの)微妙な違い,陰影,ニュアンス
nub	切り残り,切り株 / 塊 / 《単数形で》《話》(話などの)要点,核心《+『of』+『名』》
nubbin	変形(病気)で生長できない果実・(一般に)小さい塊・小塊; トウモロコシの発育不良の穂, 育ちの悪い木の実; 要点
nubile	(女性が)結婚適齢期の,年ごろの
nuclear	『核の』,細胞核の / [『原子』]『核の』
nuclear disarmament	(国際協定などによる)非核武装
nuclear energy	[原子]核エネルギー
nuclear family	(夫婦と子供のみで構成される)核家族
nuclear fission	核分裂
nuclear fusion	核融合
nuclear physics	原子物理学
nuclear reactor	原子炉
nucleate	核を持った / 核になる / …'を'核にする
nuclei	nucleusの複数形
nucleic acid	核酸(細胞核蛋白質を形成する物質)
nucleolus	(細胞核内の)小核,核仁
nucleon	核子(原子核を構成する陽子と中性子)
nucleonics	[原子]核工学
nucleus	中心,核 / (生物の)細胞核 / 原子核
nude	裸の,裸体の / 〈C〉(美術作品の)裸体画,裸像,ヌード / 〈C〉裸体の人 / 《the ~》裸の状態
nudge	(注意などを引くために,特にひじで)…'を'軽くつつく / (特にひじで)軽くつつく / (特にひじで)軽くつつくこと
nudism	裸体主義
nudist	裸体主義者
nudity	〈U〉裸の状態 / 〈C〉裸のもの;裸体画(像)
nugatory	無価値の,取るに足らない / 効力のない
nugget	天然金属塊;(特に)金塊
nuisance	(…に)『迷惑をかける人』(『もの』,『行為』);〈U〉(…に対する)『迷惑』,不愉快《+『to』+『名』》
nuisance tax	小額消費税(個々の購入品について支払う税)
nuisance value	《時にa~》(敵・相手に対する)妨害(障害)効果
nuke	核兵器 / 原子力発電所 / …'を'核兵器で攻撃する・(おどけて)食品を電子レンジで調理する・核爆弾、核兵器、原子核、原子力、原子力潜水艦、原子力発電所
null	(法律上)無効の,効力のない / ゼロの,無価値の / (数学で集合が)空(から)の
null set	(数学で)空集合
nullah	(インドで大雨の後などにできる)水路
nullification	無効,破棄,取り消し / 無効の状態
nullify	…'を'無効にする / …'を'ゼロにする,台なしにする
nullity	〈U〉(法律上の)無効;〈C〉(文書・行為などの)法律上無効のもの / 〈U〉無;無力,無意味 / 〈C〉つまらぬ人(物)
num.	numeral; numerals
numb	麻痺(まひ)した,感覚を失った,しびれた / …'の'感覚を失わせる,'を'しびれさせる
number	〈U〉〈C〉(数えて得られる)『数,数量』 / 〈C〉(概念としての)『数,数字』 / 〈C〉『番号』 / 〈C〉(演奏会や演劇の)番組,出し物;曲目 / 〈C〉(雑誌の)号 / 〈U〉(文法で)数(すう) / 《複数形で》数の上の優勢 / 《複数形で》算数 / 〈C〉《単数形で》《話》(商品としての)洋服の1点;商品,売り物 / 〈C〉《単数形で》《俗》女の子 / …'を'数える / (…の中に,…として)…'を'含める,加える《+『among』(『with, as』)+『名』》 / …'に'番号をつける / …'の'数となる / 《しばしば受動態で》…'の'数を制限する / 総計(…に)なる《+『in』+『名』〈数〉》
number one	《話》本人自身,自分独自 / (組織などの)長,指揮者,ボス / 《名詞の前または後に形容詞的に用いて》第一,最高級
number plate	(自動車の)ナンバープレート(《米》license plate)
numberless	(比較変化なし)《おもに文》無数の,数えきれない / 番号のない
numbers	数学,数学 / (人員などの)数の優勢 / 《米》《the~》=numbers game / 《古》詞句,韻文
numbers game	数当て賭博
numbness	無感覚,しびれ,麻痺(まひ)
numbskull	=numskull
numerable	数えることができる
numeracy	足(た)し算引き算能力,基本的な計算能力
numeral	(14,XIVなどの)『数字』 / (one, twoなどの)数詞 / 数の,数を表す
numerate	…'を'数える,数え上げる / 《おもに英》足(た)し算引き算の能力のある,数学の分かる
numeration	数えること,計算 / 数え方,計算法
numerator	(分数の)分子 / 計算者
numerical	数の,数で表した
numerology	(誕生日の数字などによる)数占い;数秘学
numerous	『非常に多い』,多数の(very many) / 多数から成る(を含む)
numismatic	貨幣(古銭)の研究(収集)の
numismatics	貨幣(古銭)の研究(収集)
numskull	とんま,あほう,まぬけ
nun	尼僧,修道女
nuncio	(外国の宮廷・政府に駐在する)ローマ教皇大使
nunnery	尼僧院,女子修道院
nuptial	結婚の;結婚式の / 《複数形で》結婚式
nurse	『看護人』,看護婦 / 子守(dry nurse) / 『乳母』(うば)(wet nurse) / 'を'『看護する』,看病する / 〈幼児〉'に'授乳する / 〈病気・けが〉'を'治そうと努める / 《話》…'を'注意して扱う,たいせつに扱う / …'を'大事に育てる / (心に)〈ある感情〉'を'いだく / 看護人(看護婦)として働く / 授乳する / 〈幼児が〉乳を飲む
nursemaid	子守女
nursery	『子供部屋』,育児室 / 苗床,苗木畑
nursery rhyme	童謡,わらべ歌
nursery school	保育園
nurseryman	苗畑の所有者,苗木屋
nursing	(預かった子を)養育(保育)する / 授乳する / {名}〈U〉 / (職業としての)看護 / 保育
nursing home	(老人・病人の)療養院 / 《英》私立小病院
nursling,nurseling	(乳母・子守に育てられている)乳飲み子,養い子 / 大事に育てられる人(もの)
nurture	…'を'養う,養育する / …'を'発展させる,伸ばす / 食物,栄養物 / 《文》養育,養成
nut	『木の実』,堅果(けんか)(クリ・ドングリなど) / (堅果の皮をむいた)中の実,仁(じん)(しばしば食用になる) / (ボトルを留める)『留めねじ』,ナット / (バイオリンなどの)糸受け;毛留め / 《話》変人;気違い / 《話》あることに熱中する人,ファン,(…)狭 / 木の実を捜す(拾う)
nut-brown	くり毛の,はしばみ毛の
nutcracker	《しばしば複数形で》クルミ割り / ホシガラス(とがった口ばしのカラス科の鳥)
nuthatch	ゴジュウカラ(ゴジュウカラ科の短い尾の鳥)
nuthouse	精神病院
nutmeat	堅果の仁(じん)(食用の部分)
nutmeg	ニクズクの木(種子)(東インド諸島産;種子は香料・薬用になる);〈U〉ニクズク,ナツメッグ
nutpick	くるみ掘り出し器
nutria	〈C〉ヌートリア(南米産の海狸(かいり)ネズミでその毛皮は珍重される) / 〈U〉その毛皮
nutrient	栄養に富む / 〈C〉栄養物,栄養剤
nutriment	〈U〉〈C〉栄養分,養分;食物(food)
nutrition	(生物の)栄養摂取 / 栄養分,食物
nutritional	栄養の,栄養的の
nutritionist	栄養士;栄養学者
nutritious	栄養に富む
nutritive	栄養に富む / 栄養の,栄養に関する
nuts	気違いの;気違いじみた / (…に)夢中の《+『about』(『over』)+『名』》 / (失望・不幸・拒否・失敗などを示して)ちぇっ,だめだ,くそっ
nutshell	(クルミなどの)殻(から)
nuttiness	木の実が多いこと / 木の実のような風味
nutty	木の実(堅果)の多い,木の実のなる / (味が)木の実のような / 《話》気違いの,気違いじみた
nuzzle	〈動物が〉…'に'鼻をすり寄せる,'を'鼻でこする / (…に)麦をすり付ける;寄り添う《+『up against』(『to』)+『名』》
nylon	〈U〉『ナイロン』 / 《複数形で》ナイロンの靴下
nymph	『ニンフ』(ギリシア・ローマ神話で泉・川・森・海などに住む美しい妖精) / 美少女 / 若虫(じゃくちゅう)(トンボ・セミなどの不完全変態をする昆虫の幼虫)
nymphet	(10代前半の)魅力的な少女
nymphomania	〈U〉(女性の)異常性欲 / 色欲症
nymphomaniac	〈C〉色欲症の女性 / 過剰な性的欲求をもつ女性
